lex	Str
	
-`	
-\	\
-\	\
-\	\
ȁ	V
à	V
ā	V
á	V
á	V
á	V
ä	V
â	V
āa	VV
áaàân	VVCVVC
áan	VVC
áän	VVC
àbí	VCV
ȁ-bhȁn	VCV
ȁn	VC
àn	VC
àō	VV
bȁ	CV
bá	CV
bá	CV
bàâ	CVV
báa	CVV
báabȁ	CVVCV
bàādhèen	CVVCChVV
báȁn	CVVC
bàāpʌ̏	CVVCV̈
bádhɤ̄	CVChV̈
bālōn	CVCVC
bān	CVC
bán	CVC
báudhɤ̄	CVVChV̈
bæ̏æn	CVVC
bʌ́	CV̈
bʌ́ʌ̏	CV̈V̈
bʌ́dhɤ̄	CV̈ChV̈
bʌ̏ŋbʌ̏ŋdhɤ̄	CV̈CCCV̈CCChV̈
bʌ̀ŋ̄bʌ̀ŋ̄dhɤ	CV̈CCCV̈CCChV̈
bȅ	CV
bȅ	CV
bèê	CVV
bèê gīŋ	CVV CVCC
bèê kpá	CVV CCV
bèêdhɛ́yí	CVVChVCV
bèêdhɛ́yízʌ̏	CVVChVCVCV̈
bèêgā	CVVCV
bèŋ̄bèŋ̄dhɤ	CVCCCVCCChV̈
bȅzʌ̏	CVCV̈
bɛ̄a	CVV
bɛ̏ankȁa	CVVCCVV
bɛ̏ɛ	CVV
bɛ̀ɛ̂n	CVVC
bɛ́i	CVV
bɛ̏n	CVC
bɛ̏n gbɔ̄	CVC CCV
bȉ	CV
bīa	CVV
Bīȁ	BVV
bìʌn	CVV̈C
bȉbȉdhɤ̄	CVCVChV̈
bídhɤ̄	CVChV̈
bȉn	CVC
bín	CVC
bín	CVC
bín	CVC
bíngātīi	CVCCVCVV
bìŋ̄bìŋ̄dhɤ	CVCCCVCCChV̈
bìo	CVV
bíɔ	CVV
bíɔnbȉɔn	CVVCCVVC
bíɔnbȉɔnzʌ̏	CVVCCVVCCV̈
bíɔŋbȉɔŋ	CVVCCCVVCC
bīɤ	CVV̈
bīɤ lɯ̏	CVV̈ CV̈
blȁ	CCV
blàā	CCVV
blàāblàā	CCVVCCVV
blȁan	CCVVC
blábládhɤ̄	CCVCCVChV̈
bládhɤ̄	CCVChV̈
blákpɔ́	CCVCCV
blʌ́	CCV̈
blʌ̏ʌ	CCV̈V̈
blʌ̀ʌ̄	CCV̈V̈
blʌ̀ʌ̂	CCV̈V̈
blʌ̀ʌ̄dhɛ́	CCV̈V̈ChV
blʌ́dhɛ̏	CCV̈ChV
blʌ̀ŋ	CCV̈CC
blʌ́ŋ	CCV̈CC
bléedhɛ̏	CCVVChV
bléedhɤ̄	CCVVChV̈
blēŋdhɤ	CCVCCChV̈
blɛ̀ɛ̂	CCVV
blɛ̀ɛ̄dhe	CCVVChV
blɛ̀ɛ̄dhɛ́	CCVVChV
blɛ̏ɛzʌ̏	CCVVCV̈
blɛ́ŋblɛ̏ŋ	CCVCCCCVCC
blīi	CCVV
blíkɤ́	CCVCV̈
blìŋ̄blìŋ̄dhɤ	CCVCCCCVCCChV̈
Blòŋ̄dhɛ̏	BCVCCChV
Blōȍdhɛ	BCVVChV
blɔ̄	CCV
blɔ́ɔ	CCVV
blɔ́ɔ̏bhɛ̏n	CCVVCCV
blɔ̄ɔ̏n	CCVVC
blɔ̄ɔ̏n	CCVVC
blɔ́ɔ̏n	CCVVC
blɔ̄ɔ̏ntàadhɛ̏	CCVVCCVVChV
blɔ́ɔ̏nzʌ̏	CCVVCCV̈
blɤ̄ɤ	CCV̈V̈
blȕ	CCV
blȕgbɔ̄ŋ	CCVCCVCC
blùû	CCVV
blúȕbȉ	CCVVCV
blȕudhɤ̄	CCVVChV̈
blɯ̏	CCV̈
blɯ́	CCV̈
blɯ̏ʌ{yīʌ}	CCV̈V̈ {CVV̈}
blɯ́blɯ́	CCV̈CCV̈
blɯ́blɯ́dhɤ̄	CCV̈CCV̈ChV̈
blɯ́bhɔ̏	CCV̈ChV
blɯ́dȕ	CCV̈CV
blɯ́dhɛyí	CCV̈ChVCV
blɯ́dhɛyízʌ̏	CCV̈ChVCVCV̈
blɯ́dhīin	CCV̈CVV
blɯ́gȁn	CCV̈CVC
blɯ́gbɔ̏ɔn	CCV̈CCVVC
blɯ́kɒ̄ɒ	CCV̈CVV
blɯ́kʌ̄bhɛ̏n	CCV̈CV̈CV
blɯ́ŋ	CCV̈CC
blɯ̏pʌ̏	CCV̈CV̈
blɯ̀ɯ̂	CCV̈V̈
blɯ́ɯ	CCV̈V̈
blɯ́ɯdȕ	CCV̈V̈CV
blɯ́ɯn yùā	CCV̈V̈C CVV
blɯ́ɯŋ	CCV̈V̈CC
blɯ́yɒ̏ɒn	CCV̈CVVC
bȍ	CV
bō	CV
bòʌ̄	CVV̈
bòī	CVVV
bɔ̄	CV
bɔ́	CV
bɔ́asíɤ	CVVCVV̈
bɔ̄bhɛ̏n	CVCV
bɔ́n	CVC
bɔ́nkánpʌ̏	CVCCVCCV̈
bɔ́ŋ	CVCC
bɔ́ŋbɔ̏ŋ	CVCCCVCC
bɔ̀ɔ̄	CVV
bɔ̄ɔ	CVV
bɔ̏tóu	CVCVV
bɤ́	CV̈
bɤ̄ɯ̏	CV̈V̈
bɤ́ɯ	CV̈V̈
bɤ́ɯdhɤ̄	CV̈V̈ChV̈
bɤ̄ɯ̏gɯ́	CV̈V̈CV̈
bɤ̄ɯ̏gɯ́dhɛ̏	CV̈V̈CV̈ChV
bɤ̄ɯ̏kpɤ̄	CV̈V̈CCV̈
bɤ̄ɯ̏zʌ̏	CV̈V̈CV̈
bɤ́ɯzʌ̏	CV̈V̈CV̈
bū	CV
bú	CV
bȕadhɤ̄	CVVChV̈
būʌ̏dhɤ̄n	CVV̈CChV̈
būʌ̏npʌ̏	CVV̈CCV̈
būdhazʌ̏	CVChVCV̈
búdhɤ̄	CVChV̈
bùeî	CVVV
būgā	CVCV
búlá	CVCV
búlázʌ̏	CVCVCV̈
būn	CVC
būn	CVC
búsɯ̏	CVCV̈
bȕu	CVV
búu	CVV
búȕ	CVV
būudhɤ	CVVChV̈
bɯ́ʌŋbɯ̏ʌŋ	CV̈V̈CCCV̈V̈CC
bɯ̄ʌŋbɯ̄ʌŋdhɤ	CV̈V̈CCCV̈V̈CCChV̈
bɯ̏dhɤ̄	CV̈ChV̈
bɯ́dhɤ̄	CV̈ChV̈
bɯ̏ŋ	CV̈CCC
bɯ̏ɤ	CV̈V̈
bɯ̏ɤ	CV̈V̈
bɯ̏ɤ	CV̈V̈
bɯ̏ɤbȉ	CV̈V̈CV
bhȁ	ChV
bhȁ	ChV
bhȁ	ChV
bhā	ChV
bhá	ChV
bhá	ChV
bhä	ChV
bhàa	ChVV
bhāa	ChVV
bháa	ChVV
bháa	ChVV
bháa	ChVV
bháa	ChVV
bháȁ	ChVV
bhàabhán	CVVCV
bhàân	CVV
bhāân	CVV
bháan	CVV
bhȁan kʌ̄	CVV CV̈
bhȁazʌ̏	ChVVCV̈
bhȁbha	ChVChV
bhábhɛ̏n	ChVCV
bhȁdʌ̄	ChVCV̈
bhȁdhʌ́n	CVCV̈
bhádhȅ	ChVChV
bhádhɛ̏	ChVChV
bhȁn	CV
bhȁn	CV
bhȁn	CV
bhān	CV
bhān	CV
bhān	CV
bhān	CV
bhán	CV
bhán	CV
bhän	CV
bhȁnkún	CVCVC
bhȁnwȕn	CVwVC
bhānzīgā	CVCVCV
bhàŋ	ChVCC
bhàŋ̄	ChVCC
bhàŋbhá	ChVCCChV
bháŋgló	CVCCCCV
bhȁŋgɤ̏	ChVCCCV̈
bhàŋ̄zʌ̏{dhȕ}n	ChVCCCV̈ {CV}
bhȁwȕn	ChVwVC
bházʌ̏	ChVCV̈
bházʌ̏	ChVCV̈
bhɒ̀ɒ̄	ChVV
bhɒ̄ɒ	ChVV
bhɒ́ɒdhɤ̄	ChVVChV̈
bhɒ́ɒ-dhȕn	ChVV CV
bhɒ̄ɒgā	ChVVCV
bhɒ́ɒŋ̏	ChVVCC
bhɒ́ɒŋ̏{zʌ̏}-dhȕn	ChVVCC {CV̈} CV
bhæ̏æ	ChVV
bhæ̀æ̂	ChVV
bhæ̏æn	CVV
bhæ̏ængā	CVVCV̄
bhʌ̄	ChV̈
bhʌ̄	ChV̈
bhʌ́ʌ	ChV̈V̈
bhʌ̄ʌn yɔ̏n	CV̈V̈ CVC
bhʌ̏bhɛ̄npíɤdhē	CV̈CVCVV̈ChV
bhʌ̏n	CV̈
bhʌ́n	CV̈
bhʌ́n	CV̈
bhʌ̄ŋ	CV̈CC
bhʌ́ŋ	CV̈CC
bhē	ChV
bhé	ChV
bhèā	ChVV CV̈
bhéȉ	ChVV
bhéȉzʌ̏	ChVVCV̈
bhēŋ	ChVCC
bhɛ̄	ChV
bhɛ́bhán	ChVCV
bhɛ́ɛbhɛ̏	ChVVChV
bhɛ̏ɛn	CVV
bhɛ̀ɛn	CVV
bhɛ̀ɛ̂n	CVV
bhɛ̄ɛn	CVV
bhɛ̄ɛ̂n	CVV
bhɛ̏ɛnzʌ̏	CVVCV̈
bhɛ̄gɯ́dhɛ̏	ChVCV̈ChV
bhɛ́i	ChVV
bhɛ́lɛ́bhɛ̏lɛ̏	ChVCVChVCV
bhɛ̏n	CV
-bhɛ̏n	CV
bhɛ̄n	CV
bhɛ̄n	CV
bhɛ̄n tīi sɛ̏	CV CVV CV
bhɛ̄nsʌ̏	CVCV̈
bhɛ̄ŋ	CVCC
bhī	ChV
bhī	ChV
bhían	CVV
bhīɒŋ	ChVVVCC
bhīɒŋ	ChVVVCC
bhīɒŋgā	ChVVVCCCV
bhìʌ̄n	CVV̈
bhīdhīntɤ̄	CVCVCV̈
bhīi	ChVV
bhìibhín	CVVCV
bhīin yɔ̏n	CVV CVC
bhīingā	CVVCV
bhīiŋ	CVVCC
bhīn	CV
bhȉŋ	ChVCC
bhīŋ	ChVCC
bhīŋ	CVCC
bhíŋ	CVCC
bhīŋbhiŋdhɤ	ChVCCChVCCChV̈
bhīŋgā	CVCCCV
bhīɤ̏fǽædʌ̄	ChVV̈fVVCV̈
bhlȁ	ChCV
bhlȁ	ChCV
bhlà	ChCV
bhlá	ChCV
bhlāȁ	ChCVV
bhláa	ChCVV
bhláabhlȁ	ChCVVChCV
bhlʌ̀	ChCV̈
bhlʌ́	ChCV̈
bhlʌ̀kʌ̄pʌ̏	ChCV̈CV̈CV̈
bhlʌ̀kpɔ́dhē	ChCV̈CCVChV
bhlʌ̀ŋ̂	ChCV̈CC
bhlʌ̀zʌ̏	ChCV̈CV̈
bhlé	ChCV
bhlɛ́ɛbhlɛ̏	ChCVVChCV
bhlɛ̀ȉ	ChCVV
bhlɛ́ŋbhlɛ̏ŋ	ChCVCCChCVCC
bhlō	ChCV
bhlòô	ChCVV
bhlɔ̄	ChCV
bhlɔ̈bhlɔ̂	ChCVChCV
bhlɔ̏lɯ̏	ChCVCV̈
bhlɤ̂	ChCV̈
bhlɤ̂dhɛ̏	ChCV̈ChV
bhlɤ́ŋbhlɤ̏	ChCV̈CCChCV̈
bhlɤ̀ɤ̏	ChCV̈V̈
bhlɤ̀ɤ̄gbȁa	ChCV̈V̈ CCVV
bhlȕ	ChCV
bhlú	ChCV
bhlúubhlȕzʌ̏	ChCVVChCVCV̈
bhlɯ̀	ChCV̈
bhnlā	CCV
bhnlàa	CCVV
bhnlàa gɔ̄ɔ̂n	CCVV CVVC
bhnlàȁbɔ̏	CCVVCV
bhnlàabɔ̏ bhɛ̀ɛ̂bhɛ̏n	CCVVCV CVVCV
bhnlʌ̏	CCV̈
bhnlʌ̀ʌ	CCV̈V̈
bhnlʌ̀ʌ yùā	CCV̈V̈ CVV
bhnlʌ̄ʌzʌ̏	CCV̈V̈CV̈
bhnlɛ́ŋbhlɛ̏ŋ	CCVCCCCVCC
bhnlìi	CCVV
bhnlɔ̏ɔ	CCVV
bhnlɔ́ɔbhnlɔ̏	CCVVCCV
bhnlūʌ	CCVV̈
bhnlɯ̏	CCV̈
bhȍ	ChV
bhō	ChV
bhóŋ	ChVCC
bhōo	ChVV
bhòodhʌ́n	ChVVCV̈
bhɔ̏	ChV
bhɔ̄	ChV
bhɔ̄	ChV
bhɔ́	ChV
bhɔ̏adhʌ	ChVVChV̈
bhɔ̏an	CVV
bhɔ̄ân	CVV
bhɔ́ʌ̏	ChVV̈
bhɔ́bhnlí	CVChCV
bhɔ̏dhɛn	CVChV
bhɔ̏kúʌ̏	ChVCVV̈
bhɔ̏n	CV
bhɔ̏n	CV
bhɔ̏n	CV
bhɔ́ntrʌ̏	CVCCV̈
bhɔ̏ŋ	ChVCC
bhɔ̄ŋ	ChVCC
bhɔ̄ŋ	ChVCC
bhɔ́ŋ zɔ̏	ChVCC CV
bhɔ̄ŋdhɛ̏	ChVCCChV
bhɔ̀ɔ̄	ChVV
bhɔ̄ɔ̏	ChVV
bhɔ́ɔ̏	ChVV
bhɔ̀ɔ̄bhɛ̏n	ChVVCV
bhɔ́ɔ̏kpʌ̀	ChVVCCV̈
bhɔ́ɔ̈n	CVV
bhɔ̀ɔ̄pʌ̏	ChVVCV̈
bhɔ̀ɔ̄zʌ̏	ChVVCV̈
bhɔ́ɔzɔ̏	ChVVCV
bhɤ̏	ChV̈
bhɤ̏	ChV̈
bhɤ̏pʌ̏	ChV̈CV̈
bhɤ̀ɯ̏	ChV̈V̈
bhɤ̀ɯ̂	ChV̈V̈
bhɤ̏yíʌ	ChV̈CVV̈
bhȕaadhʌ	ChVVVChV̈
bhúabhȕan	CVVCVV
bhùān	CVV
bhúʌ̏	ChVV̈
bhūn	CV
bhūŋbhuŋdhɤ	ChVCCChVCCChV̈
bhūȕ	ChVV
bhúu	ChVV
bhūu gȁn	ChVV CVC
bhūȕdhɤ̄	ChVVChV̈
bhūun	CVV
bhūȕn	CVV
bhúun	CVV
bhɯ́	ChV̈
bhɯ́	ChV̈
bhɯ́ʌŋbhɯ̏ʌŋ	ChV̈V̈CCChV̈V̈CC
bhɯ̏n	CV̈
bhɯ̄n	CV̈
bhɯ̄n	CV̈
bhɯ̄ŋ	CV̈CC
bhɯ̏ɤ	ChV̈V̈
bhɯ̏ɤ	ChV̈V̈
bhɯ̀ɤ̄	ChV̈V̈
bhɯ̄ɤ	ChV̈V̈
bhɯ́ɤ	ChV̈V̈
bhɯ́ɤ̏	ChV̈V̈
bhɯ̀ɤ̄dhʌ́n	ChV̈V̈CV̈
bhɯ́ɤdhȅ	ChV̈V̈ChV
bhɯ̀ɤ̄gā	ChV̈V̈CV
bhɯ̀ɤ̄gblōogā	ChV̈V̈CCCVVCV
bhɯ́sɯ̏	ChV̈CV̈
bhɯ́zʌ̏	ChV̈CV̈
dȁ	CV
dà	CV
dȁa	CVV
dāa	CVV
Dàādhɛ̏n	DVVCChV
dàādhɛ̏n	CVVCChV
Dàān	DVVC
dàān	CVVC
dàān	CVVC
dàān dhɔ́ɔ yī	CVVC ChVV CV
dàānwȍ	CVVCwV
dáawō	CVVwV
dȁdhʌ́ɯ	CVChV̈V̈
dȁdhʌ́ɯ	CVChV̈V̈
dān	CVC
dànsȅe	CVCCVV
dàŋdá	CVCCCV
dáŋdȁŋdáŋdhɤ̄	CVCCCVCCCVCCChV̈
dȁplɤ̄ɤdhɛ̏	CVCCV̈V̈ChV
dȁsɔ̏	CVCV
dɒ̀ɒn	CVVC
dɒ̄ɒn	CVVC
dɒ́ɒn	CVVC
dʌ̄	CV̈
dʌ́ʌ̏	CV̈V̈
dʌ̄bhɛ̄n	CV̈CV
dʌ̄glúdhɛ̏	CV̈CCVChV
dʌ̄kpɔ́dʌ̏	CV̈CCVCV̈
dʌ̏ɯ	CV̈V̈
dʌ̏ɯdʌ̏ɯ	CV̈V̈CV̈V̈
dʌ̏ɯdʌ̏ɯ	CV̈V̈CV̈V̈
dʌ̏ɯwō	CV̈V̈wV
dȅ	CV
dȅ	CV
dȅ	CV
dȅbɔ̏	CVCV
dȅe	CVV
dȅe	CVV
dèŋ̄dȅ	CVCCCV
dēpītē	CVCVCV
dɛ̏	CV
dɛ̏bhɛ̏n	CVCCV
dɛ̏bhnlɔ̄ɔdʌ̄	CVCCVVCV̈
dɛ́dɛ̏	CVCV
dɛ̀ɛ	CVV
dɛ̄ɛ̏n	CVVC
dɛ̄ɛ̏n	CVVC
dɛ̀ī	CVV
dɛ̀īdȁbhɛ̏n	CVVCVCV
dɛ̄n	CVC
dȉan	CVVC
dȉan	CVVC
dìan	CVVC
dȉʌ	CVV̈
dìbhānsɯ̏	CVCVCV̈
dīȉ	CVV
dīidhɤn	CVVCChV̈
dīin	CVVC
dȉiŋ	CVVCC
dȉn	CVC
dīn	CVC
dīn	CVC
dín	CVC
dín	CVC
dȉŋ	CVCC
dȉŋ	CVCC
dīɔŋ	CVVCC
díɤŋ	CVV̈CC
dō	CV
dō	CV
dōdō	CVCV
dōdō	CVCV
dòŋ	CVCC
dóŋdó	CVCCCV
dȍo	CVV
dōsɛ̄n	CVCVC
dɔ̄	CV
dɔ̄	CV
dɔ̀ā	CVV
dɔ̀ā	CVV
dɔ̀ā	CVV
dɔ̏dhɛ	CVChV
dɔ̏n	CVC
dɔ̏n	CVC
dɔ̏n	CVC
dɔ̄n	CVC
dɔ́n	CVC
dɔ́n	CVC
dɔ́ŋdɔ̏n	CVCCCVC
dɔ̀ɔ̄	CVV
dɔ́ɔ	CVV
dɔ̀ɔn	CVVC
dɔ̏pɤ́ʌ̏	CVCV̈V̈
dɔ̏sɔ̄tȁ	CVCVCV
dɔ̀ū	CVV
dɔ̀ū lɯ̏	CVV CV̈
dɤ̄	CV̈
dɤ̀ŋ	CV̈CC
dɤ̏ŋdhɤ	CV̈CCChV̈
dɤ̀ŋ̄gā	CV̈CCCV
dɤ́ŋgɤ́dɤ̏ŋgɤ̏	CV̈CC CV̈CC
dɤ̄zʌ̏	CV̈CV̈
drá	CCV
dràan	CCVVC
dràān	CCVVC
drʌ́ʌdrʌ̏	CCV̈V̈CCV̈
drʌ́ʌndrʌ̏n	CCV̈V̈CCCV̈C
drɛ́ɛndrɛ̏n	CCVVCCCVC
drɛ́ŋdrɛ̏ŋ	CCVCCCCVCC
drȉiŋ	CCVVCC
dródhɤ̄	CCVChV̈
dróŋ	CCVCC
drɔ́ɔ	CCVV
drɔ́ɔ bhūȁn	CCVV CVVC
drɔ́ɔdrɔ̏	CCVVCCV
drɔ̏ɔn	CCVVC
drɤ́ŋdrɤ̏ŋ	CCV̈CCCCV̈CC
drūʌ	CCVV̈
drùɛ̏ɛ	CCVVV
drùɛ̏n	CCVVC
drùuŋ̂bhɛ̏	CCVVCCCV
drɯ́ʌdrɯ̏ʌ	CCV̈V̈CCV̈V̈
drɯ̏ŋ	CCV̈CCC
dȕ	CV
dȕ	CV
dú	CV
dùa	CVV
dùā	CVV
dúaandȕan	CVVVCCVVC
dùākʌ̄pʌ̏	CVVCV̈CV̈
dùān	CVVC
dùʌ	CVV̈
dùʌ	CVV̈
dūʌ	CVV̈
dȕʌlúu	CVV̈CVV
dúdhɤ̄	CVChV̈
dúeŋdhɤ̄	CVVCCChV̈
dȕɛ	CVV
dȕklɔ̄ɔlɯ̏	CVCCVVCV̈
dȕkwī	CVCwV
dūn	CVC
dùŋ	CVCCC
dúŋ	CVCC
dúŋ	CVCCC
dùɤ	CVV̈
dūɤ	CVV̈
dȕɤɤ	CVV̈V̈
dùū	CVV
dùūdhɤ	CVVChV̈
dȕun	CVVC
dɯ̄	CV̈
dɯ́	CV̈
dɯ́ʌ	CV̈V̈
dɯ́ʌ-sɯ́	CV̈V̈ CV̈
dɯ̄gɔ̏bhɛ̏n	CV̈CVCV
dɯ́n	CV̈C
dhȁ	ChV
dhā	ChV
dhā	ChV
dhȁa	ChVV
dháȁ	ChVV
dhȁadhʌ́n	ChVVCV̈
dhȁadhēn	CVVChV
dhȁan	CVV
-dhȁan	CVV
dhàān	CVV
dhȁankʌ̄bhɛ̏n	CVVCV̈CV
dhàanzʌ̏	CVVCV̈
dháasí	ChVVCV
dhābhɯ̏ɤ	ChVChV̈V̈
dhāgā	ChVCV
dhāgbláwȍ	ChVCCCVwV
dhākpɤ̄	ChVCCV̈
-dhȁn	CV
dhān	CV
dhán	CV
dhán	CV
dhán và	CV vV
dhāŋ̏	ChVCC
dhāŋ̏gā	ChVCCCV
dháŋgá	ChVCCCV
dhāŋ̏gɯ́dhɛ̏	ChVCCCV̈ChV
dhàŋtàa	ChVCCCVV
dhásígɔ̏bhɛ̏n	ChVCVCVCV
dhāyán	ChVCVC
dhɒ̏ɒn	CVV
dhɒ̀ɒn	CVV
dhɒ̀ɒnpʌ̏	CVVCV̈
dhʌ̏	ChV̈
dhʌ̀	ChV̈
dhʌ̀ʌ̂	ChV̈V̈
dhʌ́ʌdhɤ̄	ChV̈V̈ChV̈
dhʌ̀ʌn	CV̈V̈ CV̈
dhʌ̀ʌn	CV̈V̈
dhʌ́dhēdhʌ́n	CV̈ChVCV̈
dhʌ́dhēn	CV̈ChV
dhʌ́dhɛ̏nwȕn	CV̈ChVwVC
dhʌ́dhōŋ-dhȕn	CV̈ChVCC CV
dhʌ́n	CV̈
-dhʌ́n	CV̈
dhʌ́n púu	CV̈ CVV
dhʌ́n sɛ́ɛ̈n	CV̈ CVVC
dhʌ́n sɛ́ɛ̈n dhȕn bhȁ blʌ̏ʌ	CV̈ CVVC CV ChV CCV̈V̈
dhʌ́ngɔ̄ɔ̂dhʌ́n	CV̈CVVCCV̈
dhʌ́ngɔ̄ɔ̂n	CV̈CVVC
dhʌ́ngɔ̄ɔ̂nzʌ̏	CV̈CVVCCV̈
dhʌ̀ŋ	CV̈CC
dhʌ̀ŋ	CV̈CC
dhʌ̏ŋkúʌ̈dhē	CV̈CCCVV̈ChV
dhʌ̀ŋzʌ̏	CV̈CCCV̈
-dhȅ	ChV
dhē	ChV
dhē	ChV
dhē gbóȍ	ChV CCVV
dhèā	ChVV
dhēbɔ̏	ChVCV
dhēbhɛ̏ndʌ̄	ChVCVCV̈
dhédhéngbȁa	ChVCVCCVV
dhèe	ChVV
dhée	ChVV
dhée	ChVV
dhéepɛ̏n	ChVVCVC
dhéesȕɤ	ChVVCVV̈
dhēglú	ChVCCV
dhēglúdhʌ́dhēn	ChVCCVCV̈ChV
dhēglúdhʌ́dhēnzʌ̏	ChVCCVCV̈ChVCV̈
dhēglúdhʌ́ngɔ̄ɔ̏n	ChVCCVCV̈CVVC
dhēglúdhʌ́ngɔ̄ɔ̏nzʌ̏	ChVCCVCV̈CVVCCV̈
dhēglúdhēbɔ̏	ChVCCVChVCV
dhēglúdhēzʌ̏	ChVCCVChVCV̈
dhēglúgɔ̄ɔ̏dhʌ́nzʌ̏	ChVCCVCVVCCV̈CV̈
dhēglúgɔ̄ɔ̏n	ChVCCVCVVC
dhēglúgɔ̄ɔ̏nzʌ̏	ChVCCVCVVCCV̈
dhēglúzʌ̏	ChVCCVCV̈
dhēgɔ̄n	ChVCVC
dhèī	ChVV
dhéi	ChVV
dhēklɤ̀ɤ	ChVCCV̈V̈
dhēkpɔ́dhȅ	ChVCCVChV
dhēpʌ̄	ChVCV̈
dhēsɯ́gɔ̄ɔ̏n	ChVCV̈CVVC
dhɛ̏	ChV
dhɛ̏	ChV
dhɛ̏	ChV
-dhɛ̏	ChV
-dhɛ̏	ChV
-dhɛ̏	ChV
dhɛ̀	ChV
dhɛ̄	ChV
dhɛ́	ChV
dhɛ́	ChV
dhɛ̏adhíɤ	ChVVChVV̈
dhɛ̏adhíɤ	ChVVChVV̈
dhɛ̏bíʌ̏dhɛn	ChVCVV̈CChV
dhɛ̏bōsɯ̏	ChVCVCV̈
dhɛ́dhɛ́n	CVCV
dhɛ́dhɛ́n yúa	CVCV CVV
dhɛ̀ɛ	ChVV
dhɛ̀ɛ̄	ChVV
dhɛ̀ɛ̄dhɛ̏	ChVVChV
dhɛ́ɛdhɛ̏	ChVVChV
dhɛ̀ɛdhɛ́n	CVVCV
dhɛ́ɛdhɤ̄	ChVVChV̈
dhɛ̏ɛn	CVV
dhɛ̀ɛn	CVV
dhɛ̀ɛ̏n	CVV
dhɛ̄ɛ̂n	CVV
dhɛ̄ɛ̂n gɔ̄ŋ	CVV CVCC
dhɛ̀ɛ̏ngā	CVVCV
dhɛ́gā	ChVCV
dhɛ̏gȁkɔ̏	ChVCVCV
dhɛ̏gȁyȁn	ChVCVCVC
dhɛ̏glōodhɛ̏	ChVCCVVChV
dhɛ̏gȍpȉʌ	ChVCVCVV̈
dhɛ̏kpɒ̀ɒdhíɤ	ChVCCVVChVV̈
dhɛ̏kpɒ̀ɒyȉ	ChVCCVVCV
dhɛ̏lʌ́ʌ	ChVCV̈V̈
dhɛ̀n	CV
dhɛ̄n	CV
dhɛ̂n	CV
dhɛ̂ngā	CVCV
dhɛ́ŋ	CVCC
dhɛ̏pʌ́ʌ̏dhɛ	ChVCV̈V̈ChV
dhɛ̏púu	ChVCVV
dhɛ̏tīi	ChVCVV
dhɛ̏tīidhɛ̏	ChVCVVChV
dhɛ̏yàāpʌ̏	ChVCVVCV̈
dhɛ̏yȁbhɛ̏n	ChVCVCV
dhȉ	ChV
dhī	ChV
dhī	ChV
dhí	ChV
dhìa	ChVV
dhìa	ChVV
dhìā	ChVV
dhía	ChVV
dhíȁan	CVVV
dhīadhīan	CVVCVV
dhȉan	CVV
dhìɒɒbhɛ̏n	CVVVCCV
dhìʌ̄	ChVV̈
dhìʌ̄bhɛ̏n	CVV̈CV
dhìʌdhíʌn	CVV̈CVV̈
dhìʌn	CVV̈
dhìʌ̂n	CVV̈
dhíʌŋ	ChVV̈CC
dhȉdháa	ChVChVV
dhȉdháakʌ̄bhɛ̏n	ChVChVVCV̈CV
dhídhȁan	ChVCVV
dhídhȁanzʌ̏	ChVCVVCV̈
dhȉdháapʌ̏	ChVChVVCV̈
dhīdhe	ChVChV
dhȉi	ChVV
dhìī	ChVV
dhìībɔ̏{-dhȕ}n	ChVVCV {CV}
dhȉin	CVV
dhìin	CVV
dhīin	CVV
dhȉin kláŋ	CVV CCVCC
dhȉizʌ̏	ChVVCV̈
dhíkábhɛ̏n	ChVCVCCV
dhȉkúʌdhē	ChVCVV̈ChV
dhīŋ	ChVCC
dhȉo	ChVV
dhìɔ̄	ChVV
dhíɔ̈n	CVV?
dhȉɤ	ChVV̈
dhíɤ	ChVV̈
dhíɤ	ChVV̈
dhíɤ	ChVV̈
dhíɤ̏	ChVV̈
dhíɤ-bɔ̄	ChVV̈ CV
dhíɤ̏dhɛ	ChVV̈ChV
dhíɤ-gán	ChVV̈ CVC
dhȉɤɤ	ChVV̈V̈
dhíɤ-sɯ́	ChVV̈ CV̈
dhíɤtó	ChVV̈CV
dhíɤ-tó	ChVV̈ CV
dhíɤtódhɛ̏	ChVV̈CVChV
dhȉɤyí	ChVV̈CV
dhíɤzʌ̏	ChVV̈CV̈
dhó	ChV
dhóʌ̏	ChVV̈
dhódhón	ChVCV
dhȍdhɔ́ɔpíɤsɯ̏zʌ̏	ChVChVVCVV̈CV̈CV̈
dhōɛ́nlɤ̏	CVVCV̈
dhȍkúʌ̏sɯ̏	ChVCVV̈CV̈
dhóŋbho	ChVCCChV
dhȍŋdho	ChVCCChV
dhōŋzʌ̄bhɛ̏ɛn	ChVCCCV̈CVV
dhòŋ̂	ChVCC
dhòo	ChVV
dhòō	ChVV
dhóo	ChVV
dhóȍ	ChVV
dhòobɔ̏{-dhȕ}n	ChVVCV {CV}
dhōo-dhȕn	ChVVCV
dhɔ̏	ChV
dhɔ́	ChV
dhɔ̏dhɔ̏n	CVCV
dhɔ́dhɔ́n	CVCV
dhɔ̏kàā	ChVCVV
dhɔ̀n	CV
dhɔ̄n	CV
dhɔ̀ŋ	ChVCC
dhɔ̀ŋ̄	ChVCC
dhɔ̀ŋtrɔ̄ɔ̏	ChVCCCCVV
dhɔ̀ŋtrɔ̄ɔ̏plɤ̀ɤ	ChVCCCCVVCCV̈V̈
dhɔ̀ɔ	ChVV
dhɔ̀ɔ̄	ChVV
dhɔ́ɔ	ChVV
dhɔ́ɔ	ChVV
dhɔ̀ɔ̄bhàa	ChVVChVV
dhɔ̀ɔ̄bhàadhʌ̏n	ChVVChVVCV̈
dhɔ́ɔdɔ̄bhȁn	ChVVCVCV
dhɔ̀ɔdhɔ́	ChVVChV
dhɔ̀ɔdhɔ́n	CVVCV
dhɔ́ɔgɔ̏	ChVVCV
dhɔ́ɔkóʌ̏dhɤ̄	ChVVCVV̈ChV̈
dhɔ̏ɔn	CVV
dhɔ̀ū	ChVV
-dhɤ̄	ChV̈
-dhɤ̄	ChV̈
dhɤ́	ChV̈
dhɤ́	ChV̈
dhɤ́	ChV̈
dhɤ́	ChV̈
dhɤ́ʌ̏	ChV̈V̈
dhɤ́n	CV̈
dhɤ̏ɤ	ChV̈V̈
dhɤ́ɤdhɤ̏	ChV̈V̈ChV̈
dhɤ́ɤdhɤɤ	ChV̈V̈ChV̈V̈
dhú	ChV
dhú	ChV
dhȕaadhȕaadhɤ̄n	CVVVCVVVChV̈
dhȕaadhȕaan	CVVVCVVV
dhȕaadhȕaan	CVVVCVVV
dhȕaan	CVVV
dhúadhȕadhɛn	CVVCVVChV
dhùan	CVV
dhūænzʌ̏	CVVVCV̈
dhúʌ̏	ChVV̈
dhūʌ̂n	CVV̈
dhúʌ̈nbɔ̏	CVV̈CV
dhùen	CVV
dhūɛn	CVVV
dhȕn	CV
dhūn	CV
dhūn	CV
dhȕɤ	ChVV̈
dhūɤ	ChVV̈
dhūɤ	ChVV̈
dhūɤdhe	ChVV̈ChV
dhūɤdhe tɤ́ŋ	ChVV̈ChV CV̈CC
dhȕtīi	ChVCVV
dhȕu	ChVV
dhùu	ChVV
dhùû	ChVV
dhúu	ChVV
dhúu púu	ChVV CVV
dhúun	CVV
dhúun	CVV
dhúuŋ	ChVVCC
dhúuŋgā	ChVVCCCV
dhȕutīi	ChVVCVV
dhȕuzʌ̏	ChVVCV̈
n̄	C
dh̀n dh́n	C C
n̄ká	CCV
Ɗóȍdhɛ	DhVVChV
è	V
ɛ̀	V
ɛ̀	V
fá	fV
fȁa	fVV
fāȁ	fVV
fáa	fVV
fáafȁ	fVVfV
fàān	fVVC
fáfȁ	fVfV
fʌ̀ɯ̄fʌ̀ɯ̄dhɤ	fV̈V̈fV̈V̈ChV̈
fɛ́ɛ	fVV
fɛ́ɛbhɛ̏n	fVVCV
fɛ̀ɛ̂n	fVVC
fɛ́ɛzʌ̏	fVVCV̈
fɛ́fɛ́dhɤ̄	fVfVChV̈
fɛ̄i	fVV
fía	fVV
fíabhɛ̏n	fVVCV
fíasɯ̏	fVVCV̈
fìʌ̄	fVV̈
fȉʌfȉʌdhɤ̄	fVV̈fVV̈ChV̈
fìi	fVV
fȉn	fVC
fíŋ	fVCC
fíŋ	fVCCC
flá	fCV
flæ̏æn	fCVVC
flʌ́ʌ	fCV̈V̈
flʌ́ʌ̏	fCV̈V̈
flʌ́ʌflʌ́ʌ	fCV̈V̈fCV̈V̈
fléȅ	fCVV
flèŋ	fCVCC
flèŋdhʌ́	fCVCCCV̈
flɛ̏ɛn	fCVVC
flɛ́ŋ	fCVCCC
flíȉ	fCVV
flíŋ	fCVCCC
flɔ́	fCV
flɤ́	fCV̈
flū	fCV
flùflú	fCVfCV
flùu	fCVV
flɯ́	fCV̈
fɔ̏dhɤ̄	fVChV̈
fɔ̄ŋ	fVCC
fɤ̏	fV̈
fɤ̄dhɛ̏	fV̈ChV
fɤ́ŋfɤ̏	fV̈CCfV̈
fɤ́ɤ̏	fV̈V̈
fɤ̄ɤdhɛ̏	fV̈V̈ChV
fɤ́ɤfɤ̏	fV̈V̈fV̈
fɤ̄ɯ	fV̈V̈
fɤ̄yí	fV̈CV
fùʌ	fVV̈
fùû	fVV
gȁ	CV
gā	CV
gā	CV
gā	CV
gàan	CVVC
gàān	CVVC
gāgā	CVCV
gȁn	CVC
gán	CVC
gán	CVC
gāzʌ̏	CVCV̈
gɒ̏ɒ	CVV
gʌ̄ʌpȉʌklú	CV̈V̈CVV̈CCV
gʌ̄n	CV̈C
gʌ̈n	CV̈C
gʌ̄ɯ	CV̈V̈
gʌ̄ɯbhɛ̏n	CV̈V̈CV
gɛ̂	CV
gɛ̏an	CVVC
gɛ̀an	CVVC
gɛ̏dhʌ́ngā	CVCCV̈CV
gɛ̏dhɛn	CVCChV
gɛ̏dhɛ́n	CVCChV
gɛ̏dhɛ́nkwɛ̄ɛdhɛ̏	CVCChVCwVVChV
gɛ́ɛn	CVVC
gɛ́iŋ	CVVCC
gɛ̏n	CVC
gɛ̏ngȁlɯ́	CVCCVCV̈
gɛ́ngɛ̏n	CVCCVC
gɛ̏nkpɤ̄ɯdhɛ̏	CVCCCV̈V̈ChV
gɛ̏nkpɤ̄ɯdhɤ	CVCCCV̈V̈ChV̈
gɛ̏nkwɛ̄ɛdhɛ̏	CVCCwVVChV
gɛ̏nlȍbhɛ̏n	CVCCVCV
gɛ́ŋkȍ	CVVCCCV
gȉ	CV
gīȁ	CVV
gīȁgȉa	CVVCVV
gīȁgȉawō	CVVCVVwV
gȉan	CVVC
gīan	CVVC
gían	CVVC
gíanzʌ̏	CVVCCV̈
gídhán	CVCV
gíȉ	CVV
gíin	CVVC
gíinzʌ̏	CVVCCV̈
gȉkpɛ́	CVCCV
gíŋ	CVCC
gȉpȉn	CVCVC
glá	CCV
glàȁ	CCVV
gláaglȁ	CCVVCCV
glȁan	CCVVC
gláan	CCVVC
gládhiɤdhɛ̏	CCVChVV̈ChV
gládhiɤsɯ́bhɛ̏n	CCVChVV̈CV̈CV
glʌ́ŋglʌ̏ŋ	CCV̈CCCCV̈CC
glègɔ̏	CCVCV
glȅŋ	CCVCC
glȅŋzʌ̏	CCVCCCV̈
glɛ̏ŋ	CCVCC
glȉglȉdhɤ̄	CCVCCVChV̈
glìī	CCVV
glìî	CCVV
glìīsɯ̏	CCVVCV̈
glòo	CCVV
glòo	CCVV
glōo	CCVV
glɔ̄ŋdʌ̄	CCVCCCV̈
glɔ̀ɔ	CCVV
glɔ̄ɔ	CCVV
glɔ́ɔ	CCVV
glɔ́ɔglɔ̏	CCVVCCV
glɔ́ɔglɔ̏dhɛ	CCVVCCVChV
glɔ̀ɔsɯ̏	CCVVCV̈
glɔ̀ɔsɯ̏	CCVVCV̈
glɤ̀ɤ	CCV̈V̈
glɤ̀ɤbɔ̀ɔbhɛ̏n	CCV̈V̈CVVCV
glȕ	CCV
glȕ	CCV
glȕ	CCV
glú	CCV
glúʌ̏kwȉ	CCVV̈CwV
glȕbhadháä	CCVChVChVV
glȕdʌ̄	CCVCV̈
glȕdhí	CCVChV
glúdhī	CCVChV
glùɛīn	CCVVVC
glùɛ̄n	CCVVC
glùɛ̄nzʌ̏	CCVVCCV̈
glȕgɔ̄bhɛ̏n	CCVCVCCV
glȕkʌ̄bhɛ̏n	CCVCV̈CV
glȕkpá	CCVCCV
glȕpíɤpʌ̏	CCVCVV̈CV̈
glúsʌ̏	CCVCV̈
glúu	CCVV
glùūzʌ̏	CCVVCV̈
glúyāabhɛ̏n	CCVCVVCV
glɯ́lɯ̏	CCV̈CV̈
glɯ̀ɯ̂	CCV̈V̈
glɯ́ɯzʌ̏	CCV̈V̈CV̈
gȍ	CV
gó	CV
gȍo	CVV
gòȍ	CVV
gōo	CVV
gōô	CVV
góo	CVV
góö	CVV
góo dhòo dɔ̏ɔ	CVV ChVV CVV
gɔ̏	CV
gɔ̏	CV
gɔ̏	CV
gɔ̄	CV
gɔ́	CV
gɔ́	CV
gɔ̂	CV
gɔ́bhȁn	CVCV
gɔ̏bhɛ̏n	CVCV
gɔ̄bhìʌ̄n	CVCVV̈
gɔ̏dhíɤbhɛ̏n	CVChVV̈CV
gɔ̏gā	CVCV
gɔ̏gȁgɯ́dhɛ̏	CVCVCV̈ChV
gɔ̏n	CVC
gɔ̏n	CVC
gɔ̀n	CVC
gɔ̄n	CVC
gɔ̄ŋgɔ̄ŋ	CVCCCVCC
gɔ́ɔ	CVV
gɔ́ɔ̏	CVV
gɔ́ɔ̏	CVV
gɔ̄ɔ̏bhɛ̏dhēn	CVVCCVChV
gɔ̀ɔbhɛ̏n	CVVCCV
gɔ̏ɔn	CVVC
gɔ̀ɔn	CVVC
gɔ̀ɔ̄n	CVVC
gɔ̄ɔ̏n	CVVC
gɔ̄ɔ̏ndʌ̄	CVVCCV̈
gɔ̄ɔ̏ndē	CVVCCV
gɔ̄ɔ̏ngbóȍ	CVVCCCVV
gɔ̄ɔ̏nklɤ̀ɤ	CVVCCCV̈V̈
gɔ́ɔnyùā	CVVCCVV
gɔ̄ɔpʌ̏	CVVCV̈
gɔ̏pʌ̏	CVCV̈
gɔ́ugɔ̏	CVVCV
gɔ́ugɔ̏	CVVCV
gɔ̀ɯ̄	CVV̈
gɤ́ŋ̏	CV̈CC
gɤ̀ɤ̏	CV̈V̈
gū	CV
gú	CV
gȕa	CVV
gùʌ̄	CVV̈
gúɛdúkpȍ	CVVCVCCV
gúɛfīʌn	CVVfVV̈C
gúgbɔ̄	CVCCV
gúlɤ̀tȁ	CVCV̈CV
gȕŋ	CVCCC
gùŋzȉʌ	CVCCCVV̈
gȕɤ	CVV̈
gùɤ̄	CVV̈
gȕɤgā	CVV̈CV
gȕɤgbɔ̄ŋ	CVV̈CCVCC
gȕɤkpɤ̄	CVV̈CCV̈
gȕɤpúuyí	CVV̈CVVCV
gúu	CVV
gúudʌ̄	CVVCV̈
gùun	CVVC
gúun	CVVC
gɯ́	CV̈
gɯ́	CV̈
gɯ́ʌ	CV̈V̈
gɯ́ʌŋgɯ̏ʌŋ	CV̈V̈CCCV̈V̈CC
gɯ́-dān	CV̈ CVC
gɯ́-gā	CV̈ CV
gɯ́gādhe	CV̈CVChV
gɯ́glȕdhē	CV̈CCVChV
gɯ̀ŋ̄	CV̈CC
gɯ̀ŋ̄zʌ̏	CV̈CCCV̈
gɯ́ɤ	CV̈V̈
gɯ́-sìɤ̂	CV̈ CVV̈
gɯ́sìɤ̂bhɛ̄n	CV̈CVV̈CV
gɯ́sìɤ̂dhē	CV̈CVV̈ChV
gɯ́sìɤ̂sɯ̏	CV̈CVV̈CV̈
gɯ́ɯzʌ̏	CV̈V̈CV̈
gbȁ	CCV
gbà	CCV
gbà	CCV
gbā	CCV
gbā	CCV
gbā	CCV
gbá	CCV
gbâ	CCV
gbȁa	CCVV
gbȁa	CCVV
gbàā	CCVV
gbāa	CCVV
gbāa	CCVV
gbáa	CCVV
gbàabóŋ	CCVVCVCC
gbàādhūn	CCVVCCV
gbàāgā	CCVVCV
gbāȁn	CCVVC
gbàāzɔ̀ŋ̄	CCVVCVCC
gbȁbhɯɤ	CCVChV̈V̈
gbȁdhɛn	CCVCChV
gbágɛ̀īnpʌ̏	CCVCVVCCV̈
gbāklɯ̄dʌ̄	CCVCCV̈CV̈
gbȁn	CCVC
gbàn	CCVC
gbān	CCVC
gbán	CCVC
gbân	CCVC
gbân	CCVC
gbántȁ	CCVCCV
gbāntʌ́ʌ	CCVCCV̈V̈
gbȁntȉa	CCVCCVV
gbánzlɤ̀ɤdhɛ̏	CCVCCCV̈V̈ChV
gbáŋklú	CCVCCCCCV
gbāŋkɔ́	CCVCCCV
gbāpʌ̏	CCVCV̈
gbȁvían	CCVvVVC
gbɒ̄ɒ	CCVV
gbɒ̀ɒn	CCVVC
gbɒ̀ɒnsɯ̏	CCVVCCV̈
gbɒ̄ɒpʌ̏	CCVVCV̈
gbǣæ̏	CCVV
gbǣæ̏	CCVV
gbæ̀æ̂n	CCVVC
gbʌ́	CCV̈
gbʌ̄ŋ̏	CCV̈CC
gbʌ̄ŋ̏bhɯɤ	CCV̈CCChV̈V̈
gbʌ̄ŋ̏gā	CCV̈CCCV
gbʌ́ŋgbʌ̏ŋ	CCV̈CCCCV̈CC
gbʌ̏ɯ	CCV̈V̈
gbʌ̀ɯ	CCV̈V̈
gbʌ̏ɯgbʌ̏ɯ	CCV̈V̈CCV̈V̈
gbēdhēnkȕn	CCVCVCVC
gbédhiɤbɔ̄pʌ̏	CCVChVV̈CVCV̈
gbéȅ	CCVV
gbéegbȅ	CCVVCCV
gbéëzʌ̏	CCVVCV̈
gbèī	CCVV
gbȅŋ	CCVCC
gbēŋ	CCVCC
gbēŋbhɛ̏ɛ	CCVCCCVV
gbēŋgbànlɯ̏	CCVCCCCVCCV̈
gbēŋgbēŋ	CCVCCCCVCC
gbɛ̄	CCV
gbɛ́a	CCVV
gbɛ́a	CCVV
gbɛ́ɛdhɤ̄	CCVVChV̈
gbɛ̀ɛn	CCVVC
gbɛ̀ɛn	CCVVC
gbɛ́gbɛ̏	CCVCCV
gbɛ̄gbɛ̄zʌ̏	CCVCCVCV̈
gbɛ́ï	CCVV
gbɛ̀iŋ	CCVVCC
gbɛ̂n	CCVC
gbía	CCVV
gbīidhɤn	CCVVCChV̈
gbìin	CCVVC
gbíiŋ̈	CCVVCC
gbíngbȉn	CCVCCCVC
gbío	CCVV
gbȉɤ	CCVV̈
gblá	CCCV
gblàā	CCCVV
gblàȁgblá	CCCVVCCCV
gblāŋ	CCCVCC
gbláudhɤ̄	CCCVVChV̈
gblɒ̏ɒn	CCCVVC
gblʌ́	CCCV̈
gblʌ̀ʌ̂	CCCV̈V̈
gblʌ̏ʌ gú tȁ wɯ̏	CCCV̈V̈ CV CV wV̈
gblʌ̄ʌ̂n	CCCV̈V̈C
gblɛ̏ibȉzʌ̏	CCCVVCVCV̈
gbló	CCCV
gblōŋ	CCCVCC
gblȍo	CCCVV
gblòo	CCCVV
gblōo	CCCVV
gblȍo dhʌ́n	CCCVV CV̈
gblɔ̏dhēslʌ̄n	CCCVChVCCV̈C
gblɔ̄ɔ	CCCVV
gblɤ́gblɤ́	CCCV̈CCCV̈
gblɯ́	CCCV̈
gblɯ̄ʌ	CCCV̈V̈
gblɯ̄ʌdhūn	CCCV̈V̈CCV
gblɯ̏ŋ	CCCV̈CC
gblɯ̏ɯn	CCCV̈V̈C
gblɯ́ɯnzʌ̏	CCCV̈V̈CCV̈
gbȍ	CCV
gbō	CCV
gbó	CCV
gbō kɔ́	CCV CV
gbȍa	CCVV
gbōbhɯ̀ɤ	CCVChV̈V̈
gbōgā	CCVCV
gbóŋgbó	CCVCCCCV
gbōŋgbōdhɤ	CCVCCCCVChV̈
gbóö	CCVV
gbóödhɛ̏	CCVVChV
gbɔ̄	CCV
gbɔ̄	CCV
gbɔ́	CCV
gbɔ̀ngbɔ̀nsɯ̏	CCVCCCVCCV̈
gbɔ̄ŋgbɔ̄	CCVCCCCV
gbɔ̄ŋgbɔ́	CCVCCCCV
gbɔ̄ŋgbɔ̄ tȉa	CCVCCCCV CVV
gbɔ̀ŋ̂	CCVCC
gbɔ̀ɔ̄	CCVV
gbɔ̏ɔn	CCVVC
gbɔ̄ɔ̂n	CCVVC
gbɔ́ɔtōo	CCVVCVV
gbɔ̄sɛ́	CCVCV
gbɔ̏udhɤ̄	CCVVChV̈
gbɤ̄	CCV̈
gbɤ̏ŋ	CCV̈CC
gbȕa	CCVV
gbúʌ̈ {lɯ́}	CCVV̈ {CV̈}
gbuɛ	CCVV
gbūŋ	CCVCC
gbɯ̄ŋ	CCV̈CC
gwā	CwV
gwȁa	CwVV
gwāâdhɛ̏	CwVVChV
gwāâdhɤ	CwVVChV̈
gwāan	CwVVC
gwāndhē	CwVCChV
gwàngā	CwVCCV
gwʌ̏ʌ	CwV̈V̈
gwɛ̂	CwV
gwɛ̏ɛ	CwVV
ì	V
ìȉ	VV
īn	VC
íŋ	VCCC
kȁ	CV
kā	CV
kā	CV
kā	CV
ká	CV
ká	CV
ká	CV
ká	CV
ká	CV
kä	CV
kâ	CV
kàȁ	CVV
kàā	CVV
kāa	CVV
kāȁ	CVV
kāȁ	CVV
kāȁ	CVV
kāȁ	CVV
kāȁ	CVV
káa	CVV
káa	CVV
kāâgā	CVVCV
kàān	CVVC
kàān	CVVC
kàān	CVVC
kàân	CVVC
káän	CVVC
kȁantȁ	CVVCCV
kāfé	CVfV
káfé yí	CVfV CV
kāflēe	CVfCVV
kāká	CVCV
kȁkàō	CVCVV
kálé	CVCV
kán	CVC
kán bhɔ̏	CVC ChV
kȁnsō	CVCCV
kāŋ̏	CVCC
káŋbáä	CVCCCVV
kāŋ{kā}-dhȕn	CVCC {CV} CV
kɒ̀ɒ	CVV
kɒ̄ɒ	CVV
kɒ́ɒ	CVV
kʌ̄	CV̈
kʌ̄dhɛ̏	CV̈ChV
kʌ̏ŋ	CV̈CC
kʌ̏ŋ	CV̈CCC
kʌ̀ŋ̄	CV̈CC
kʌ̀ŋ̄	CV̈CCC
kʌ̄pʌ̏yāa	CV̈CV̈CVV
kʌ̏ɯ	CV̈V̈
kʌ́ɯ	CV̈V̈
kʌ̄wȕn	CV̈wVC
kê	CV
kèȅ	CVV
kée	CVV
kèȉ	CVV
kèȉdhɛ	CVVChV
kèȉdhɤ̄	CVVChV̈
kɛ̀adhē	CVVChV
kɛ́ɛ	CVV
kɛ́ɛ	CVV
kɛ́ɛ bhɔ̏a	CVV ChVV
kɛ̏i	CVV
kɛ̏i sȍo	CVV CVV
kɛ̏i zlɤ̀ɤ	CVV CCV̈V̈
kɛ̏idhɛ	CVVChV
kɛ̀n	CVC
kɛ̀ngā	CVCCV
kɛ̈npʌ̄	CVCCV̈
kìā	CVV
kíakȉa	CVVCVV
kìān	CVVC
kìān	CVVC
kían	CVVC
kíin	CVVC
kínzūu	CVCCVV
kìoŋgbɔ̄	CVVCCCCV
klȁa	CCVV
klȁa kpūdhe	CCVV CCVChV
klȁagā	CCVVCV
klāan	CCVVC
klàŋ̄	CCVCC
kláŋ	CCVCC
klàŋ̄ dhʌ́n	CCVCC CV̈
klàŋ̄ kɔ́	CCVCC CV
klàŋ̄gɔ̏bhɛ̏n	CCVCCCVCV
klàŋ̄gɔ̏dhe	CCVCCCVChV
klɒ̄ɒ	CCVV
klɒ́ŋ̈	CCVVCC
klʌ̏ʌ	CCV̈V̈
klʌ́ʌklʌ̏	CCV̈V̈CCV̈
klʌ́ʌklʌ̏dhɛ	CCV̈V̈CCV̈ChV
klʌ̀ʌn	CCV̈V̈C
klʌ̀ʌn	CCV̈V̈C
klʌ́n	CCV̈C
klʌ̄ŋ	CCV̈CC
klɛ̄yɔ̈n	CCVCVC
kló	CCV
klòâ	CCVV
klóbhɔ̄dhe	CCVChVChV
klòȍ	CCVV
klòô	CCVV
klɔ́	CCV
klɔ̀ȁ	CCVV
klɔ́a	CCVV
klɔ̏ŋ	CCVCC
klɔ́ɔklɔ̏	CCVVCCV
klɔ̀ɔ̏n	CCVVC
klɤ̏	CCV̈
klɤ́ŋgbɤ̄	CCV̈CCCCV̈
klɤ̏ɤ	CCV̈V̈
klɤ̀ɤ	CCV̈V̈
klɤ̀ɤ̄	CCV̈V̈
klɤ̀ɤ̄	CCV̈V̈
klɤ̀ɤ̄dhɤ	CCV̈V̈ChV̈
klɤ̀ɤ̄klɤ̀ɤ̄	CCV̈V̈ CCV̈V̈
klɤ̀ɤ̄klɤ̀ɤ̄	CCV̈V̈ CCV̈V̈
klɤ̀ɤklɤ̀ɤ{-dhȕ}n	CCV̈V̈ CCV̈V̈ {CV}
klɤ̀ɤ̄zʌ̏	CCV̈V̈CV̈
klȕ	CCV
klú	CCV
klú	CCV
klȕ kɤ́dhɤ̄ŋgɤ́	CCV CV̈ChV̈CCCV̈
klùʌ̏	CCVV̈
klūʌ	CCVV̈
klūʌdhūn	CCVV̈CCV CV̈
klùū	CCVV
kȍ	CV
kō	CV
kō	CV
kō	CV
kó	CV
kó	CV
kó	CV
kö	CV
kô	CV
kōʌ	CVV̈
kōʌ̏	CVV̈
kōʌ̏	CVV̈
kóʌ	CVV̈
kóʌ	CVV̈
kóʌ̏	CVV̈
kóʌʌ	CVV̈V̈
kóʌ̏ʌn	CVV̈V̈C
kōgȁ	CVCV
kōká	CVCV
kòŋ	CVCC
kōŋ̏	CVCC
kȍo	CVV
kósɯ́dhē	CVCV̈ChV
kɔ̏	CV
kɔ̏	CV
kɔ̏	CV
kɔ̏	CV
kɔ́	CV
kɔ̏apʌ̄	CVVCV̈
kɔ́bhádhán	CVCCVCV
kɔ́bhíŋdhɤ̄	CVCCVCCChV̈
kɔ̏dhʌ́ngā	CVCV̈CV
kɔ̏dhʌ́ngā dɔ̄ zīʌn	CVCV̈CV CV CVV̈C
kɔ̏dhʌ́ngā gɔ̄n	CVCV̈CV CVC
kɔ̏dhʌ́ngā gbáazʌ̏	CVCV̈CV CCVVCV̈
kɔ̏dhʌ́ngā vàzʌ̏	CVCV̈CV vVCV̈
kɔ́dhʌ́ntée	CVCV̈CVV
kɔ̏dhɛ	CVChV
kɔ̏dhɛ́	CVChV
kɔ̏dhɛkwɛ̏ɛ	CVChVCwVV
kɔ̏dhɛtȁa	CVChVCVV
kɔ́dhi	CVChV
kɔ́dhɔ̏ŋdhɔ́	CVChVCCChV
kɔ̏klʌ̀ {ɛ̀}?	CVCCV̈ {V}?
kɔ̏kpȉ	CVCCV
kɔ̏kpɤ̄	CVCCV̈
kɔ̏kpɤ̄ɤdhɛ̏	CVCCV̈V̈ChV
kɔ̏kwɛ̄ɛ	CVCwVV
kɔ̏kwɛ̄ɛdhɛ̏	CVCwVVChV
kɔ̏lɤ̀ɤ	CVCV̈V̈
kɔ́nkɔ̏n	CVCCVC
kɔ̄ŋ	CVCC
kɔ̏ɔ	CVV
kɔ̏ɔ	CVV
kɔ̄ɔ	CVV
kɔ̀ɔbhɛ̏n	CVVCCV
kɔ̄ɔbhɛ̏n	CVVCV
kɔ̄ɔdhɛ̏	CVVChV
kɔ̀ɔngɔ̏ɔn	CVVCCVVC
kɔ̏tȁa	CVCVV
kɤ̏	CV̈
kɤ̄	CV̈
kɤ́	CV̈
kɤ̀dhàn kɤ́dhán	CV̈CV CV̈CV
kɤ́dhánkɤ̏dhȁn	CV̈CVCV̈CV
kɤ̏pʌ̄	CV̈CV̈
kú	CV
kūʌdhūn	CVV̈CCV
kúbhádhán	CVCVCV
kȕlȕ	CVCV CV̈
kùn	CVC
kùn	CVC
kūn	CVC
kún	CVC
kùŋ̂	CVCC
kùɤ̏	CVV̈
kȕɤgā	CVV̈CV
kȕu	CVV
kɯ̄ʌkɯ̄ʌ	CV̈V̈CV̈V̈
kpȁ	CCV
kpȁ	CCV
kpā	CCV
kpá	CCV
kpá	CCV
kpȁa	CCVV
kpàa	CCVV
kpáä	CCVV
kpàadhɛ̏n	CCVVCChV
kpàakpá	CCVVCCV
kpáakpȁ	CCVVCCV
kpáakpȁdhɛ	CCVVCCVChV
kpáan	CCVVC
kpàanzʌ̏	CCVVCCV̈
kpâbhɔ̏n	CCVCCV
kpádhɤ̄	CCVChV̈
kpȁkpȁdhɤ̄	CCVCCVChV̈
kpákpádhɤ̄	CCVCCVChV̈
kpān	CCVC
kpán	CCVC
kpán	CCVC
kpanklù	CCVCCCV
kpāsɛ̄n	CCVCVC
kpàɯ̏	CCVV̈
kpɒ̀ɒ̄	CCVV
kpɒ̀ɒ̄	CCVV
kpɒ̀ɒ̄zʌ̏	CCVVCV̈
kpæ̀ǣ	CCVV
kpǽæ	CCVV
kpʌ̀	CCV̈
kpʌ̄	CCV̈
kpʌ́dhɤ̄	CCV̈ChV̈
kpʌ̏n	CCV̈C
kpʌ̀ŋ	CCV̈CC
kpʌ̀ŋ	CCV̈CCC CV̈
kpʌ́ŋ	CCV̈CCC
kpʌ́ŋ̈	CCV̈CCC
kpʌ́ŋ̈zʌ̏	CCV̈CCCCV̈
kpʌ̀ɯ	CCV̈V̈
kpʌ̀ɯ̄	CCV̈V̈
kpédhán	CCVCV
kpée	CCVV
kpée	CCVV
kpéŋ	CCVCC
kpéŋ sīɔgā	CCVCC CVVCV
kpēŋdhɤ	CCVCCChV̈
kpɛ́ȁnkpɛ́ȁdhɤ̄n	CCVVCCCVVCChV̈
kpɛ́ɛdhɤ̄	CCVVChV̈
kpɛ́ɛkpɛ́	CCVVCCV
kpɛ̄ɛn	CCVVC
kpɛ́i	CCVV
kpɛ́kpɛ́	CCVCCV
kpɛ̄ŋ	CCVCC
kpɛ̄ŋdhɤ	CCVCCCChV̈
kpɛ̄ŋdhɤ	CCVCCCChV̈
kpɛ̏zʌ̏	CCVCV̈
kpìādhɤn	CCVVCChV̈
kpíänkpíädhɤ̄n	CCVVCCCVVCChV̈
kpíankpȉan	CCVVCCCVVC
kpíʌkpȉʌ	CCVV̈CCVV̈
kpíï	CCVV
kpīidhɤn	CCVVCChV̈
kpȉin	CCVVC
kpȉiŋ	CCVVCC
kpȉiŋgā	CCVVCCCV
kpíïzʌ̏	CCVVCV̈
kpíkpȉ	CCVCCV
kpȉŋ	CCVCC
kpȉŋ	CCVCC
kpȉŋ	CCVCCC
kpīŋdhɤ	CCVCCChV̈
kpȉŋgā	CCVCCCV
kpȉŋgā	CCVCCCCV
kplȁ	CCCV
kplá	CCCV
kpláakplȁ	CCCVVCCCV
kpláakplȁdhɛ	CCCVVCCCVChV
kplán	CCCVC
kplȁwō	CCCVwV
kplɒ̏ɒ	CCCVV
kplʌ̀ʌ	CCCV̈V̈
kplʌ́n	CCCV̈C
kplɛ̏	CCCV
kplɛ̏kplɛ́	CCCVCCCV
kpló	CCCV
kplóŋ	CCCVCC
kplòo	CCCVV
kplōo	CCCVV
kplɔ̄	CCCV
kplɔ̏ŋgȅ	CCCVCCCV
kplɔ́ŋkplɔ̏ŋ	CCCVCCCCCVCC
kplɔ̀ɔ̄	CCCVV
kplɔ̄ɔn	CCCVVC
kplɔ̄ɔngā	CCCVVCCV
kplɤ́	CCCV̈
kplɤ̄ɤ̂	CCCV̈V̈
kplɤ́zȕɤbhɛ̏n	CCCV̈CVV̈CV
kplūʌn	CCCVV̈C
kplùū	CCCVV
kplɯ̀ʌ̄kplɯ̏ʌkplɯ̀ʌ̄dhɤ	CCCV̈V̈CCCV̈V̈CCCV̈V̈ChV̈
kplɯ̄ŋ	CCCV̈CC
kplɯ̄ŋzʌ̏	CCCV̈CCCV̈
kpȍ	CCV
kpó	CCV
kpódha	CCVChV
kpódhazʌ̏	CCVChVCV̈
kpódhɤ̄	CCVChV̈
kpókpódhɤ̄	CCVCCVChV̈
kpȍlɯ́	CCVCV̈
kpȍŋ	CCVCC
kpōŋ	CCVCC
kpōŋ	CCVCC
kpóŋ	CCVCC
kpòŋdhēe	CCVCCChVV
kpòŋdhēe	CCVCCChVV
kpóŋtàa	CCVCCCVV
kpóŋtàadhɛ̏	CCVCCCVVChV
kpòō	CCVV
kpōo	CCVV
kpòōdhɛ̏	CCVVChV
kpɔ́	CCV
kpɔ̄a	CCVV
kpɔ́bhɛ̏n	CCVCV
kpɔ̄n	CCVC
kpɔ̄ngɔ̏	CCVCCV
kpɔ̄ŋ	CCVCC
kpɔ̏ɔ	CCVV
kpɔ̀ɔ̏	CCVV
kpɔ̏ɔ kpɤ̄	CCVV CCV̈
kpɔ̀ɔ yīʌ	CCVV CVV̈
kpɔ̏ɔn	CCVVC
kpɤ̄	CCV̈
kpɤ̄nglɤ̄ɤ	CCV̈CCCV̈V̈
kpɤ̄ɤ	CCV̈V̈
kpɤ́ɤ	CCV̈V̈
kpɤ́ɤ̈kpȁŋgȍ	CCV̈V̈CCVCCCV
kpɤ́ɯ	CCV̈V̈
kpū	CCV
kpȕa	CCVV
kpȕa	CCVV
kpūan	CCVVC
kpúʌ	CCVV̈
kpúdhɤ̄	CCVChV̈
kpúkpúdhɤ̄	CCVCCVChV̈
kpūŋ	CCVCC
kpɯ́dhɤ̄	CCV̈ChV̈
kwȁ	CwV
kwā	CwV
kwā	CwV
kwā	CwV
kwá	CwV
kwá	CwV
kwá	CwV
kwä	CwV
kwâ	CwV
kwàȁ	CwVV
kwàâ	CwVV
kwāa	CwVV
kwāȁ	CwVV
kwāȁ	CwVV
kwáa	CwVV
kwáä	CwVV
kwàabhɛ̏n	CwVVCCV
kwàan	CwVVC
kwáän	CwVVC
kwàanglȕdȁbhɛ̏n	CwVVCCCVCVCV
kwàansɯ̏	CwVVCCV̈
kwāâzʌ̏	CwVVCV̈
kwāká	CwVCV
kwán	CwVC
kwāŋ̏	CwVCC
kwæ̀æ	CwVV
kwǽæ	CwVV
kwǽæ̏dhɛn	CwVVCChV
kwǽæ̏dhɤ̄n	CwVVCChV̈
kwǽæ̏n	CwVVC
kwʌ̄ʌ̏	CwV̈V̈
kwēe	CwVV
kwēezʌ̏	CwVVCV̈
kwēezɤ̄	CwVVCV̈
kwɛ̏	CwV
kwɛ̄	CwV
kwɛ̀ɛ̏	CwVV
kwɛ̀ɛ̏	CwVV
kwɛ̀ɛ̄	CwVV
kwɛ̀ɛ̄	CwVV
kwɛ̄ɛ	CwVV
kwɛ́ɛ	CwVV
kwɛ̄ɛdhɛ̏	CwVVChV
kwɛ́ɛ̈dhɛ̏n	CwVVCChV
kwɛ̄ɛ̂zʌ̏	CwVVCV̈
kwɛ́i	CwVV
kwɛ́n yȁn	CwVC CVC
kwī	CwV
kwí	CwV
kwí plɤ̀ɤ	CwV CCV̈V̈
kwí plɤ̀ɤ dhɛ̏	CwV CCV̈V̈ ChV
kwí pɤ̂ và	CwV CV̈ vV
kwí tɔ̏	CwV CV
kwíä bhɔ̏n	CwVV CV
kwíʌ̈dhóo	CwVV̈ChVV
kwīgā	CwVCV
kwīgā kʌ̄ bhɛ̏n	CwVCV CV̈ CV
kwīgā kɔ̀ɔn bhɛ̏n	CwVCV CVVC CV
kwlá	CwCV
kwlá téezʌ̏	CwCV CVVCV̈
kwlàȁ	CwCVV
Kwlæ̀ǣdhɤn	KwCVVCChV̈
kwlɛ̀ɛ̏	CwCVV
là	CV
làā	CVV
làbáŋ̈	CVCVCC
lagīdhēn	CVCVCV
làkédhe	CVCVChV
lȁn	CVC
làn	CVC
lân	CVC
lân kɔ́	CVC CV
lantra	CVCCCV
làŋbáä	CVCCCVV
lāŋ̂	CVCC
lāsó	CVCV
lɒ̄ɒn	CVVC
lǽængǽæ̏n	CVVCCVV
lʌ̂	CV̈
lʌ̂	CV̈
lʌ̏ʌdhɤ̄	CV̈V̈ChV̈
lʌ́ʌ̈lʌ̄	CV̈V̈CV̈
lʌ́ʌ̈nzʌ̏	CV̈V̈CCV̈
lʌ̂kʌ̄dhʌ̏n	CV̈CV̈CChV̈
lʌ̂kʌ̄dhʌ̏ngā	CV̈CV̈CChV̈CV
lʌ̏n	CV̈C
lʌ̄ŋ	CV̈CC
lʌ̄ŋgɯ́dhɛ̏	CV̈CCCV̈ChV
lʌ̄ŋlʌ̄ŋ	CV̈CCCV̈CC
lʌ̄ŋ̂	CV̈CCC
lʌ́ŋ̈	CV̈CC
lʌ́ŋ̈dhɛ̏	CV̈CCChV
lʌ̂zʌ̏	CV̈CV̈
lɛ́ɛlɛ̏	CVVCV
lɛ́lɛ́	CVCV
lɛ́ŋlɛ̏ŋ	CVCCCVCC
lȍ	CV
lȍ	CV
lòkö	CVCV
lóŋ	CVCC
lȍo	CVV
lōo	CVV
lɔ̀ŋ	CVCCC
lɔ̀ŋ̏	CVCC
lɔ́ɔ̈	CVV
lɔ́ɔ̈fìʌ̄	CVVfVV̈
lɔ́ɔn	CVVC
lɔ̄ɔn lɯ̏	CVVC CV̈
lɔ̄ɔngā	CVVCCV
lɔ̀ɔzʌ̏	CVVCV̈
lɤ̏	CV̈
lɤ̏	CV̈
lɤ́	CV̈
lɤ́	CV̈
lɤ̀ɤ	CV̈V̈
lɤ̀ɤ	CV̈V̈
lɤ́ɤ	CV̈V̈
lɤ́ɤdhɤ̄	CV̈V̈ChV̈
lɤ̏sɔ̏	CV̈CV
lɤ́ɯlɤ̏	CV̈V̈CV̈
lùû	CVV
lúu	CVV
lúu kpá	CVV CCV
lúulȕ	CVVCV
lɯ̏	CV̈
lɯ́	CV̈
lɯ́ kpǽæ	CV̈ CCVV
lɯ́dhʌ́n	CV̈CV̈
lɯ́dhɛ̀ɛ̄dhɤ	CV̈ChVVChV̈
lɯ́gɔ̏kpɤ̄	CV̈CVCCV̈
lɯ́gúŋpā	CV̈ CVCCCV
lɯ́kìā	CV̈CVV
lɯ́kɔ̏dhʌ́n	CV̈CVCV̈
lɯ́kɔ̏ɔ	CV̈CVV
lɯ́ɯdhɤ̄	CV̈V̈ChV̈
lɯ́ɯdhɤ̄	CV̈V̈ChV̈
Máadhɤ̄	MVVCChV̈
ō	V
ōo	VV
ɔ̏	V
ɤ̏	V̈
ɤ̏	V̈
ɤ̏	V̈
ɤ̄	V̈
ɤ̄	V̈
ɤ́	V̈
ɤ́	V̈
ɤ̈	V̈
pā	CV
pā	CV
pā	CV
pá	CV
pàâ	CVV
páa	CVV
pāafɛ̈n	CVVfVC
pāâgɔ́bhɛ̏n	CVVCVCV
páan	CVVC
pádhe	CVChV
pāŋ	CVCC
pápá	CVCV
pápádhɤ̄	CVCVChV̈
pāyɛ́ɛ̈n	CVCVVC
pɒ́ɒ	CVV
pɒ́ɒgā	CVVCV
pæ̀ǣ	CVV
pʌ̄	CV̈
pʌ̄	CV̈
pʌ́	CV̈
pʌ̄ dhíɤ̈	CV̈ ChVV̈
pʌ̄ kpɤ̄	CV̈ CCV̈
pʌ́ʌ̈	CV̈V̈
pʌ́ʌpʌ̏	CV̈V̈CV̈
pʌ̄bȉdhɛn	CV̈CVCChV
pʌ̄bhlé	CV̈ChCV
pʌ̄gā	CV̈CV
pʌ̄kàāpʌ̏	CV̈CVVCV̈
pʌ̏-kʌ̄	CV̈ CV̈
pʌ̄kpȁbhɛ̏n	CV̈CCVCV
pʌ̄kpȁdhɛ	CV̈CCVChV
pʌ̄tée	CV̈CVV
pȅ	CV
pȅ	CV
pēdhēn	CVCV
pēdhēngā	CVCVCV
pēe	CVV
pȅedʌ̄	CVVCV̈
pēedhɛ̀n	CVVCV
pɛ́	CV
pɛ̀ɛ̂	CVV
pɛ̀ɛ̄sɯ̏	CVVCV̈
pɛ̏n	CVC
pɛ̏n	CVC
pɛ́n	CVC
pɛ̂n	CVC
pɛ̏n yùā	CVC CVV
pɛ̄ŋ	CVCCC
pɛ̄ŋgā	CVCCC CV
pȉa	CVV CV̈
pīan	CVVC
pían	CVVC
pían	CVVC
pȉʌ	CVV̈
pȉʌn	CVV̈C
pīʌn	CVV̈C
píʌnpíʌn	CVV̈CCVV̈C
píi	CVV
pīidhɤn	CVVCChV̈
píigɯ́dhɛ̏	CVVCV̈ChV
píigbéëdhɛ̏	CVVCCVVChV
pȉikɔ́	CVVCV
pȉiŋdhɤ̄	CVVCCChV̈
píitàa	CVVCVV
píitàadhɛ̏	CVVCVVChV
pīn	CVC
pìô	CVV
píɔnpȉɔn	CVVCCVVC
píɔŋpȉɔŋ	CVVCCCVVCC
pȉɤ	CVV̈
pȉɤ	CVV̈
pìɤ̄	CVV̈
píɤ	CVV̈
pȉɤbhȁn	CVV̈CV
pȉɤgā	CVV̈CV
pìɤ̄gā	CVV̈CV
pȉɤgbɔ̄	CVV̈CCV
píɤklɤ̀ɤ̂zʌ̏	CVV̈CCV̈V̈CV̈
pīɤŋdhɤ	CVV̈CCChV̈
pȉɤsáŋ	CVV̈CVCC
pȉɤsòo	CVV̈CVV
pȉɤsɯ́	CVV̈CV̈
plȁ	CCV
plȁadhɛ	CCVVChV
plāan	CCVVC
plàkàī	CCVCVV
plàŋ̂	CCVCC
plʌ̀ʌn	CCV̈V̈C
plʌ́ʌplʌ̏	CCV̈V̈CCV̈
plʌ̀ʌplʌ́zʌ̏	CCV̈V̈CCV̈CV̈
plʌ̀ʌ̂zʌ̏	CCV̈V̈CV̈
plʌ́ŋ	CCV̈CC
plɛ̀	CCV
plɛ̀	CCV
plɛ́	CCV
plɛ́ŋplɛ̏ŋ	CCVCCCCVCC
plɛ̀ŋ̄zʌ̏	CCVCCCV̈
plȍo	CCVV
plòô	CCVV
plɔ̏	CCV
plɔ̏gā	CCVCV
plɔ̏ŋ	CCVCC
plɔ̏ɔ	CCVV
plɔ́ɔ	CCVV
plɤ̀ɤ	CCV̈V̈
plɤ̄ɤ	CCV̈V̈
plɤ̄ɤdhɛ̏	CCV̈V̈ChV
plɤ́ɤnplɤ̏	CCV̈V̈CCCV̈
plɯ́ŋ	CCV̈CC
plɯ́plɯ̏	CCV̈CCV̈
pó	CV
póŋ	CVCC
pōo	CVV
pōo kùn	CVV CVC
pȍtàāsɯ̏	CVCVVCV̈
pȍtàāsɯ̏	CVCVVCV̈
póɯ̈	CVV̈
pɔ́dhɤ̄	CVChV̈
pɔ́n	CVC
pɔ̄ɔ̂	CVV
pɔ́ɔ̈	CVV
pɔ́ɔn	CVVC
pɤ̄	CV̈
pɤ́	CV̈
pɤ̂	CV̈
pɤ̂dhɛ̏	CV̈ChV
pɤ̀ɯ̄	CV̈V̈
pùʌn	CVV̈C
púʌŋpȕʌŋ	CVV̈CCCVV̈CC
púɛ̈ {yùā}	CVV {CVV}
pún	CVC
púpú{-dhȕ}n	CVCV {CV}
pùū	CVV
púu	CVV
pɯ̏ɤ	CV̈V̈
pɯ́ɯ	CV̈V̈
sā	CV
sá	CV
sȁa	CVV
sàa	CVV
sāâ	CVV
sáa	CVV
sàa kɔ́	CVV CV
sàadhē	CVVChV
sàādhen	CVVCChV
sàādhenkʌ̄bhɛ̏n	CVVCChVCV̈CV
sáadhɤ̄	CVVChV̈
sȁan	CVVC
sàān	CVVC
sáan	CVVC
sȁangā	CVVCCV
säblà	CVCCV
sȁdhen	CVCChV
sákásákádhɤ̄	CVCVCVCVChV̈
sȁkpá	CVCCV
sȁn	CVC
sān	CVC
sán	CVC
sán	CVC
sángó dhɤ̀ɤ dhɤ́	CVCCV ChV̈V̈ ChV̈
sȁnzʌ̄dhe	CVCCV̈ChV
sɒ̄ɒ	CVV
sɒ́ɒ	CVV
sɒ̏ɒn	CVVC
sʌ̏	CV̈
sʌ̏	CV̈
sʌ̀ʌ̄	CV̈V̈
sʌ̀ʌ̂	CV̈V̈
sʌ́ʌ	CV̈V̈
sʌ́ʌ̈	CV̈V̈
sʌ́ʌ̈	CV̈V̈
sʌ̏ʌdhʌ́n	CV̈V̈CV̈
sʌ́ʌdhɛ̄	CV̈V̈ChV
sʌ́ʌdhɛ̏bȅ	CV̈V̈ChVCV
sʌ́ʌdhɛkɔ́	CV̈V̈ChVCV
sʌ̏ʌzʌ̏	CV̈V̈CV̈
sʌ̏bhɛ̏n	CV̈CV
sʌ̏dhɛ	CV̈ChV
sʌ́nsʌ́dhɤ̄n	CV̈CCV̈CChV̈
sʌ̄ŋ	CV̈CCC
sʌ́ŋ	CV̈CCC
sʌ̄ŋgbʌ̄	CV̈CCCCV̈
sʌ́ŋsʌ̏	CV̈CCCV̈
sé	CV
sèê	CVV
sēi	CVV
séŋdhɤ̄	CVCCChV̈
séŋséŋdhɤ̄	CVCCCVCCChV̈
sɛ́	CV
sɛ̄ȁ	CVV
sɛ̄ȁbɛ̏n	CVVCVC
sɛ̄ȁzȉan	CVVCVVC
sɛ́dʌ̄	CVCV̈
sɛ́dhɛ́n	CVCV
sɛ̏ɛ	CVV
sɛ̀ɛ̏	CVV
sɛ̀ɛ̄	CVV
sɛ̀ɛ̂	CVV
sɛ́ɛ	CVV
sɛ̏ɛbɔ̏	CVVCV
sɛ̀ɛ̄dhɛ̏	CVVChV
sɛ́ɛgā	CVVCV
sɛ́ɛlɯ́	CVVCV̈
sɛ̀ɛ̏n	CVVC
sɛ́ɛ̈n	CVVC
sɛ́ɛ̈n	CVVC
sɛ́gɔ̏	CVCV
sɛ́gɯ́bhɛ̏n	CVCV̈CV
sɛ́i	CVV
sɛ́i bhɛ̏ɛn	CVV CVV
sɛ́idhɤ̄	CVVChV̈
sɛ́ipʌ̀ŋdhɛ̏	CVVCV̈CCChV
sɛ́isīʌ	CVVCVV̈
sɛ́kɛ́	CVCV
sɛ́kɔ́	CVCV
sɛ̀n	CVC
sɛ́n	CVC
sɛ̏nsɛ̏dhɤ̄n	CVCCVCChV̈
sɛ́nsɛ́n-dhȕn	CVC CVC CV
sɛ́ntȁdhɛ	CVCCVChV
sɛ̄ŋ	CVCCC
sɛ́pían	CVCVVC
sɛ́pɔ́dhɛ̏n	CVCVCChV
sɛ̏sȉɤbhɛ̏n	CVCVV̈CV
sɛ́tɔ̏n	CVCVC
sí	CV
sí	CV
sìa	CVV
sīȁ	CVV
sīȁ	CVV
sīân	CVVC
sían	CVVC
sían	CVVC
sìʌ̂	CVV̈
sīʌ̂	CVV̈
sīʌ̂n	CVV̈C
sīi	CVV
sìisí	CVVCV
sìō	CVV
sīoo	CVVV
síɔn	CVVC
sȉɤ	CVV̈
sȉɤ	CVV̈
sȉɤ	CVV̈
sìɤ̂	CVV̈
síɤ	CVV̈
síɤ̈	CVV̈
síɤ̈	CVV̈
síɤ bhɤ̀ɯ̏	CVV̈ ChV̈V̈
síɤ̈dhɤ̄	CVV̈ChV̈
sȉɤgā	CVV̈CV
síɤkɔ́	CVV̈CV
síɤkɔ́gā	CVV̈CVCV
síɤɤzʌ̏	CVV̈V̈CV̈
síɤsīɤ	CVV̈CVV̈
síɤsíɤzʌ̏	CVV̈CVV̈CV̈
sȉɤsɯ̏	CVV̈CV̈
síɤtʌ́ʌ	CVV̈CV̈V̈
sȉɤzʌ̏	CVV̈CV̈
síɤ̈zʌ̏	CVV̈CV̈
sísúŋgā	CVCVCCCV
slȁ	CCV
slâ	CCV
slàâ	CCVV
slāan	CCVVC
slàaŋsláa	CCVVCCCCVV
sládō	CCVCV
slȁn	CCVC
släplɛ̀	CCVCCV
slǽægā	CCVVCV
slʌ̏	CCV̈
slʌ̄	CCV̈
slʌ́	CCV̈
slʌ́a	CCV̈V
slʌ̏ʌ	CCV̈V̈
slʌ̀ʌ̂	CCV̈V̈
slʌ̏ʌdhɤ̄	CCV̈V̈ChV̈
slʌ́ʌdhɤ̄	CCV̈V̈ChV̈
slʌ́ʌnslʌ̏n	CCV̈V̈CCCV̈C
slʌ̏ʌslʌ̏dhɤ̄	CCV̈V̈CCV̈ChV̈
slòô	CCVV
slóo	CCVV
slóodhɤ̄	CCVVChV̈
slɔ́aslɔ̏a	CCVVCCVV
slɔ́ŋ	CCVCC
slɔ́ŋ	CCVCC
slɔ̀ɔ	CCVV
slɔ́ɔ	CCVV
slɤ̏	CCV̈
slɤ́	CCV̈
slɤ̏ɤ	CCV̈V̈
slɤ̀ɤ̄	CCV̈V̈
slɤ̄ɤdhɤ	CCV̈V̈ChV̈
slɤ́ɤslɤ̏	CCV̈V̈CCV̈
slɤ̀ɤ̄zʌ̄bhɛ̏n	CCV̈V̈CV̈CV
slúbhɔ̏n	CCVCCV
slúun	CCVVC
slɯ́	CCV̈
slɯ̀ɯ̂	CCV̈V̈
slɯ́ɯ	CCV̈V̈
sȍ	CV
sȍ	CV
sō	CV
sòa	CVV
sōbhɛ̏n	CVCV
sōŋ	CVCC
sōŋdhɤ	CVCCChV̈
sóŋgòzʌ̏	CVCCCVCV̈
sóŋgō{lɯ̏}	CVCCCV{CV̈}
sòo	CVV
sòo	CVV
sòo	CVV
sòofàŋ̄	CVVfVCC
sòogā	CVVCV
sòosōŋdhɛ̏	CVVCVCCChV
sɔ̄	CV
sɔ́	CV
sɔ́	CV
sɔ̀a	CVV
sɔ̄dhʌ́n	CVCV̈
sɔ́gā	CVCV
sɔ̀n	CVC
sɔ́n	CVC
sɔ́n	CVC
sɔ́ngā	CVCCV
sɔ́nkɔ́	CVCCV
sɔ́nkpɛ̄ŋ	CVCCCVCC
sɔ̀ŋ̄	CVCC
sɔ́ŋ	CVCC
sɔ̀ɔ̏	CVV
sɔ̀ɔ̂	CVV
sɔ́ɔ	CVV
sɔ́ɔ	CVV
sɔ́ɔdhu	CVVChV
sɔ̀ɔn	CVVC
sɔ̀ɔ̄n	CVVC
sɔ̄ɔn	CVVC
sɔ̀ɔsɔ́	CVVCV
sɔ́ɔsɔ̏	CVVCV
sɤ̏	CV̈
sɤ̏	CV̈
sɤ̄	CV̈
sɤ̏bhɔkw̄̀̄	CV̈ChVCwVV
sɤ̏gā	CV̈CV
sɤ̄i	CV̈V
sɤ̄kpʌ̀	CV̈CCV̈
sɤ̀ŋ	CV̈CC
sɤ́ŋgɤ́sɤ̏ŋgɤ̏	CV̈CCCV̈CV̈CCCV̈
sɤ̄sɔ̀ɔ	CV̈CVV
sū	CV
sú	CV
sùa	CVV
sȕadhɤ̄	CVVChV̈
sùakʌ̄bhɛ̏n	CVVCV̈CV
súän	CVVC
súbhádhángā	CVCVCVCV
súbhōyɛ̏abha	CVChVCVVChV
súbhɯsɯ̏	CVChV̈CV̈
súdʌ̏ɯ	CVCV̈V̈
súglɤ̀ɤ	CVCCV̈V̈
súgbɔ̏	CVCCV
sūŋ	CVCCC
súɤ	CVV̈
súɤ	CVV̈
súɤgādhʌ	CVV̈CVChV̈
súpɛ́n	CVCVC
súsōŋ	CVCVCC
súsōŋgā	CVCVCCCV
sùû	CVV
sùûgɯ́dhʌ́n	CVVCV̈CV̈
sùûyāabhɛ̏n	CVVCVVCV
-sɯ̏	CV̈
-sɯ̏	CV̈
sɯ́	CV̈
sɯ́ʌsɯ̏ʌ	CV̈V̈CV̈V̈
sɯ̏ʌtȁ	CV̈V̈CV
sɯ̏-dhú	CV̈ ChV
tȁ	CV
tȁ	CV
tā	CV
tá	CV
tá	CV
tàa	CVV
tàa	CVV
tàa	CVV
táä	CVV
tàadhɛ̏	CVVChV
táägbɔ̄lɯ́	CVVCCVCV̈
tȁalɯ̏	CVVCV̈
tàān	CVVC
tàāngā	CVVCCV
táblʌ̏	CVCCV̈
tȁbhābhɛ̏n	CVCVCV
tȁdhɛ	CVChV
tȁdhūɤ	CVChVV̈
tȁdhūɤ	CVChVV̈
tȁ-gā	CV CV
tȁ-kɔ̀ɔ̄	CV CVV
tȁ-kún	CV CVC
tȁ-kpȁ	CV CCV
tán	CVC
tántádhɤ̄n	CVCCVCChV̈
tāpʌ̏	CVCV̈
tāpʌ̏dhɛ	CVCV̈ChV
táɯ̈	CVV̈
tȁ-yɤ̄	CV CV̈
tȁzɔ̏dhēn	CVCVCChV
tɒ̏ɒ	CVV
tɒ̀ɒ̄	CVV
tɒ̀ɒ̄	CVV
tʌ̏	CV̈
tʌ́	CV̈
tʌ́ʌ	CV̈V̈
tʌ́ʌ	CV̈V̈
tʌ́ʌbɔ̀āgɯ́	CV̈V̈CVVCV̈
tʌ́ʌgɔ̄n	CV̈V̈CVC
tʌ́ʌtʌ̏	CV̈V̈CV̈
tʌ́dhɛ̏	CV̈ChV
tʌ̏n	CV̈C
tʌ̄n	CV̈C
tʌ́n	CV̈C
tʌ̏ngʌ̏	CV̈CCV̈
tʌ̀ŋ	CV̈CC
tʌ̄ŋ	CV̈CC
tʌ̏ŋgʌ̏	CV̈CCCV̈
tʌ́pʌ̄	CV̈CV̈
tʌ́sɯ̏	CV̈CV̈
tʌ̄ɯ	CV̈V̈
tʌ̀ɯ̄dhʌ́n	CV̈V̈CV̈
tȅ	CV
tē	CV
té	CV
té	CV
tȅdhʌ́n	CVCV̈
tée	CVV
tée	CVV
téetȅ	CVVCV
téezʌ̏	CVVCV̈
téŋtéŋdhɤ̄	CVCCCVCCChV̈
tété	CVCV
tétúnsɯ̏	CVCVCCV̈
tëyí	CVCV
tɛ̀dhɛ̂n	CVCV
tɛ̄dhɔ́ɔnyī	CVCChVVCV
tɛ́ɛ	CVV
tɛ́ɛn	CVVC
tɛ́ɛpā	CVVCV
tɛ̀ī	CVV
tɛ̏idhɤ̄	CVVChV̈
tɛ̄nyī	CVCCV
tɛ́tɛ̏	CVCV
tíä	CVV
tȉadhɤ̄bhɛ̏n	CVVCChV̈CV
tìān	CVVC
tīan	CVVC
tíaŋtȉaŋ	CVVCCCVVCC
tīi	CVV
tíibhɛ̏n	CVVCCV
tíin	CVVC
tīizʌ̏	CVVCV̈
tíŋ	CVCC
tȉɔn	CVVC
tíɔŋtȉɔŋ	CVVCCCVVCC
tíɤŋtȉɤŋ	CVV̈CCCVV̈CC
tītī{-dhȕ}n	CVCV {CV}
tȍ	CV
tó	CV
tó	CV
tòbhāntɤ̄	CVCVCV̈
tȍbhɛ̄ngɔ̏pʌ̏	CVCVCVCV̈
tódhʌ́ngā	CVCV̈CV
tódhɛ	CVChV
tódhiɤ	CVChVV̈
tókpɤ̄ɯdhɛ̏	CVCCV̈V̈ChV
tòo	CVV
tōo	CVV
tóo	CVV
tóobhɛ̄	CVVChV
tóodhɛ̀ɛ̄dhɛ̏	CVVChVVChV
tóodhɛ̀ɛ̄dhɤ	CVVChVVChV̈
tóogbéëkʌ̄sɯ̏	CVVCCVVCV̈CV̈
tōokɔ̏	CVVCV
tóoyí	CVVCV
tótābhɛ̏n	CVCVCV
tɔ̏	CV
tɔ́	CV
tɔ́	CV
tɔ́bhán	CVCV
tɔ̏bhangbɛ̂n	CVCChVCCVC
tɔ́bhɔ̄dhe	CVChVChV
tɔ́bhɔ́dhiɤdhɛ̏n	CVCVChVV̈ChV
tɔ́bhɔ́dhiɤnyɛ̏klúʌ̈dhɛ̏	CVCVChVV̈CVCCVV̈ChV
tɔ̏dhē	CVChV
tɔ̏gɔ̀n	CVCVC
tɔ̏n	CVC
tɔ̄ŋ	CVCC
tɔ̀ɔ	CVV
tɔ̀ɔ	CVV
tɔ̄ɔ	CVV
tɔ̄ɔ	CVV
tɔ́ɔ̈	CVV
tɔ́ɔbhán	CVVCV
tɔ́ɔtɔ̏	CVVCV
tɔ́-sȉɤ	CVCVV̈
tɔ́tɔ̏	CVCV
tɤ̀dhɤ̀n	CV̈CV̈
tɤ́ŋ	CV̈CC
tɤ̄ŋgá	CV̈CCCV
tɤ̏ŋgbɤ̏	CV̈CCCCV̈
tɤ̀ɯ̄	CV̈V̈
tɤ́ɯ̈	CV̈V̈
tɤ́ɯ̈dhɤ̄	CV̈V̈ChV̈
trȁtrȁdhɤ̄	CCVCCVChV̈
trʌ̀ʌ̂	CCV̈V̈
trʌ̏ʌdhɤ̄	CCV̈V̈ChV̈
trʌ́ʌtrʌ̏	CCV̈V̈CCV̈
trʌ́ŋ	CCV̈CC
trʌ̏ŋtrʌ̏ŋdhɤ̄	CCV̈CCCCV̈CCChV̈
trɛ̀īn	CCVVC
tròō	CCVV
trōô	CCVV
tróo	CCVV
tròōkàāpʌ̏	CCVVCVVCV̈
tròōkʌ̄bhɛ̏n	CCVVCV̈CV
trɔ̄ŋ	CCVCC
trɔ̄ɔ̂	CCVV
trɔ̀ɔdhɤ̄n	CCVVCChV̈
trɔ̄ɔdhɤn	CCVVCChV̈
trɔ́ɔ̈n	CCVVC
trɤ̄	CCV̈
trɤ́ŋtrɤ̏ŋ	CCV̈CCCCV̈CC
trùʌn	CCVV̈C
trȕu	CCVV
trúu	CCVV
trɯ́ʌtrɯ̏ʌ	CCV̈V̈CCV̈V̈
trɯ́ŋ	CCV̈CC
tú	CV
tȕʌ	CVV̈
túʌŋtúʌŋ̏	CVV̈CCCVV̈CC
túɛyɔ́n	CVVCVC
tùn	CVC
tūɤ	CVV̈
tùū tùū	CVV CVV
túubhɛ̏n	CVVCCV
tūudhɤ	CVVChV̈
tùūn	CVVC
tùûn	CVVC
túun	CVVC
tùuntún	CVVCCVC
tùunzʌ̏	CVVCCV̈
ɯ̄	V̈
ɯ̄	V̈
ɯ́	V̈
ɯ́	V̈
ɯ̈	V̈
ɯ̂	V̈
ɯ́ʌ̈n	V̈V̈C
ɯ̄ká	V̈CV
và	vV
và	vV
vá	vV
vȁa	vVV
váa	vVV
váa	vVV
vȁagā	vVVCV
vȁagāyȉʌkɔ̏dhʌ́ngā	vVVCVCVV̈CVCV̈CV
váan	vVVC
váanvȁdhɛn	vVVCvVCChV
vàanván	vVVCvVC
vàāvàā	vVVvVV
vàȁzʌ̏	vVVCV̈
vádhɤ̄	vVChV̈
vàvà	vVvV
vávádhɤ̄	vVvVChV̈
vɒ̄ɒnvɒ̄ɒdhɤn	vVVCvVVCChV̈
vʌ̏	vV̈
vʌ́ɯvʌ̏ɯ	vV̈V̈vV̈V̈
vʌ̀ɯ̄vʌ̀ɯ̄dhɤ	vV̈V̈vV̈V̈ChV̈
vé	vV
véaavȅa	vVVVvVV
véë	vVV
végā	vVCV
vɛ̄	vV
vɛ̄ɛdhɛ̏	vVVChV
vɛ̄ɛdhɤ	vVVChV̈
vɛ̄ɛdhɤ	vVVChV̈
vɛ̏i	vVV
vɛ̄idhɛ̏	vVVChV
vɛ̏ŋdhɤ̄	vVCCCChV̈
vìānvìādhɤn	vVVCvVVCChV̈
víavȉa	vVVvVV
víʌʌ	vVV̈V̈
víʌvȉʌ	vVV̈vVV̈
vīi	vVV
vīn	vVC
vȉŋ	vVCCC
víɔ̈n	vVVC
vlā	vCV
vlā	vCV
vlàa	vCVV
vláanvlȁn	vCVVCvCVC
vlānkāadhɤn	vCVCCVVCChV̈
vlānvlànvlādhɤn	vCVCvCVCvCVCChV̈
vlānvlànvlān	vCVCvCVCvCVC
vlʌ́ŋvlʌ̏ŋ	vCV̈CCvCV̈CC
vlɛ̄î	vCVV
vlɛ́ŋvlɛ̏ŋ	vCVCCvCVCC
vló	vCV
vlōo	vCVV
vlɤ̄dhɤ	vCV̈ChV̈
vlùazʌ̏	vCVVCV̈
vlɯ̄	vCV̈
vlɯ́ŋ	vCV̈CC
vlɯ́ɯn	vCV̈V̈C
vlɯ́vlɯ́dhɤ̄	vCV̈vCV̈ChV̈
vòkāâ	vVCVV
vōodhɤ	vVVChV̈
vɔ́	vV
vɔ̄ŋ	vVCC
vɔ̏ɔ	vVV
vɔ̏ɔgā	vVVCV
vɤ̄	vV̈
vɤ́ɯ	vV̈V̈
vɤ́ɯzʌ̏	vV̈V̈CV̈
vùʌ̄n	vVV̈C
vùʌ̄nvùʌ̄dhɤn	vVV̈CvVV̈CChV̈
vúʌvȕʌ	vVV̈vVV̈
vúu	vVV
vȕudō	vVVCV
vɯ̈	vV̈
wȁ	wV
wȁ	wV
wà	wV
wà	wV
wā	wV
wá	wV
wȁa	wVV
wàa	wVV
wàâ	wVV
wāa	wVV
wāa	wVV
wāȁ	wVV
wāȁ	wVV
wāȁ	wVV
wáa	wVV
wáa	wVV
wáä	wVV
wȁabhȁanyȉ	wVVCVVCV
wáadhɛ̏	wVVChV
wȁadhɤ̄	wVVChV̈
wàādhūn	wVVCCV CV̈
wāadhūn	wVVCV
wȁan	wVVC
wàān	wVVC
wáan	wVVC
wáän	wVVC
wáanwȁn	wVVCwVC
wàawá	wVVwV
wáawá	wVVwV
wáawá	wVVwV
wāgɔ̄n	wVCVC
wāŋ	wVCC
wɒ̀ɒ	wVV CV̈
Wɒ̀ɒ̏dhɤ̄	WVVChV̈
wæ̀ǣ	wVV
wʌ́ɯ̈	wV̈V̈
wʌ́ɯ̈dhɛ́	wV̈V̈ChV
wʌ́ɯ̈gā	wV̈V̈CV
wʌ́ɯ̈sɛ́ɛ̈n	wV̈V̈CVVC
wʌ̏ɯzʌ̏	wV̈V̈CV̈
wé	wV
wéʌ̈	wVV̈ CV̈
wèe	wVV
wèe	wVV
wēe	wVV
wēekɔ́	wVVCV
wèepākɔ̏dhʌ́ngā	wVVCVCVCV̈CV
wèeyȉ	wVVCV
wégā	wVCV
wēi	wVV
wēiyí	wVVCV
wēŋ	wVCC
wéŋ	wVCC
wɛ̏ɛ	wVV
wɛ̏ɛbhōdhe	wVVChVChV
wɛ̏ɛdhɤ̄n	wVVCChV̈
wɛ̏i	wVV
wɛ̄n	wVC
wɛ́ŋsɔ̄dhʌ́n	wVCCCVCV̈
wìan	wVVC
wìangā	wVVCCV
wíanwȉan	wVVCwVVC
wíʌ	wVV̈
wīɤ	wVV̈
wísá	wVCV
wlā	wCV
wláan	wCVVC
wláän	wCVVC
wlàawlá	wCVVwCV
wlȁdhɤ̄	wCVChV̈
wlán	wCVC
wlȁwlȁdhɤ̄	wCVwCVChV̈
wlǽæ̏	wCVV
wlæ̏æzʌ̏	wCVVCV̈
wlʌ̀ʌ̄	wCV̈V̈
wlʌ́ʌnwlʌ̏n	wCV̈V̈CwCV̈C
wlʌ̄ɯ	wCV̈V̈
wlɛ̏ɛdhɤ̄	wCVVChV̈
wlōo	wCVV
wlɤ̄wlɤ̄zʌ̏	wCV̈wCV̈CV̈
wȍ	wV
wȍ	wV
wȍ	wV
wȍ	wV
wȍ	wV
wȍ	wV
wò	wV
wō	wV
wō	wV
wō	wV
wō	wV
wó	wV
wó	wV
wö	wV
wōʌ̏	wVV̈
wȍdȁplɛ̀bhɛ̏n	wVCVCCVCV
wȍdhíɤlȍbhɛ̏n	wVChVV̈CVCV
wȍdhíɤsɯ́bhɛ̏n	wVChVV̈CV̈CV
wȍgbíŋ̈dhɛ̏	wVCCVCCCChV
wȍká	wVCV
wōká	wV CV
wòŋ	wVCC
wōŋ̏	wVCC
wóŋ̈	wVCC
wōŋ{wō}-dhȕn	wVCC {wV} CV
wòō	wVV
wɔ̏	wV
wɔ̄	wV
wɔ̄	wV
wɔ̄	wV
wɔ́	wV
wɔ̄dhɛ̏	wVChV
wɔ́dhɤ̄	wVChV̈
wɔ̄kɔ̏	wVCV
wɔ́ŋwɔ̏ŋ	wVCCCwVCCC
wɔ̀ɔ̏	wVV
wɔ́ɔnwɔ̏n	wVVCwVC
wɔ̀ūglōʌ̂bhȁn	wVVCCVV̈CV
wɔ́yɛ́lân	wVCVCVC
wɔ́zʌ̏	wVCV̈
wɤ̄	wV̈
wɤ̀ŋ̄	wV̈CC
wɤ̄ɤ	wV̈V̈
wɤ̄ɤdhɛ̏	wV̈V̈ChV
wɤ̄ɯdhɤ	wV̈V̈ChV̈
wúdhɤ̄nkʌ̄dhíɤblɛ̀ɛ̄bhɛ̏n	wVCChV̈CV̈ChVV̈CCVVCV
wūn	wVC
wún	wVC
wúnblʌ́	wVCCCV̈
wúndánpɤ̄bhɛ̏n	wVCCVCCV̈CV
wúndɔ̏a	wVCCVV
wúndɔ̄bhɛ̏n	wVCCVCV
wúndɔ̄dhe	wVCCVChV
wúndȕadhē	wVCCVVChV
wūngā	wVCCV
wúngīâ	wVCCVV
wúngɔ̏	wVCCV
wúngɔ̏dhíɤbhɛ̏n	wVCCVChVV̈CV
wúntȁyɔ́bhɛ̏n	wVCCVCVCV
wúnyɤ̏yāansɯ̏	wVCCV̈CVVCCV̈
wúnzàāsɯ̏	wVCCVVCV̈
wúu	wVV
wɯ̄	wV̈
wɯ́	wV̈
wɯ́	wV̈
wɯ́dhɛ̏	wV̈ChV
wɯ̄kwī	wV̈CwV
wɯ̀ɯ̂	wV̈V̈
yȁ	CV
yȁ	CV
yà	CV
yā	CV
yā	CV
yá	CV
yá	CV
yȁa	CVV
yāa	CVV
yāa	CVV
yáa	CVV
yáä	CVV
yāadhɛ̏	CVVChV
yáadhɛn	CVVCChV
yàādhūn	CVVCV
yàādhūn	CVVCCV CV̈
yȁagā	CVVCV
yāagɯ́bhɛ̏n	CVVCV̈CV
yȁan	CVVC
yȁan	CVVC
yàȁn	CVVC
yáan	CVVC
yáan	CVVC
yáän	CVVC
yáanló	CVVCCV
yȁantédhē	CVVCCVChV
yȁatȁgblȍo	CVVCVCCCVV
yāazʌ̏	CVVCV̈
yádhʌ́n	CVCCV̈
yȁdhɛ	CVChV
yádhɛ̏nyɤ̄bhɛ̏n	CVCChVCV̈CV
yákȍ	CVCV
yȁkúʌ̈dhē	CVCVV̈ChV
yȁn	CVC
yán	CVC
yán	CVC
yȁnbɔ̄dhɛ̏	CVCCVChV
yángā	CVCCV
yȁngādō	CVCCVCV
yángādōzʌ̏	CVCCVCVCV̈
yánkpȍŋtȁ	CVCCCVCCCV
yánpíɤpʌ̏	CVCCVV̈CV̈
yánpúu	CVCCVV
yántīi	CVCCVV
yántóȁgɔ̏pʌ̏	CVCCVVCVCV̈
yánzìɤ̄	CVCCVV̈
yáŋ̈	CVCC
yásá	CVCV
yàɯ	CVV̈
yāyā{-dhȕ}n	CVCV {CV}
yȁyɔ́ɔ	CVCVV
yɒ̏ɒ	CVV
yɒ̀ɒbhāa	CVVChVV
yɒ̀ɒ̂n	CVVC
yǽæ	CVV
yʌ̄n	CV̈C
yʌ̀ŋ	CV̈CCC
yʌ̀ŋ	CV̈CCC
yʌ́ŋ	CV̈CC
yʌ́ŋ	CV̈CC
yʌ́ŋ	CV̈CC
yʌ́ŋ	CV̈CCC
yʌ́ŋ	CV̈CCC
yʌ́ŋdhɛ̏	CV̈CCChV
yʌ́ŋgbló	CV̈CCCCCV
yʌ́ŋtàa	CV̈CCCCVV
yʌ́ŋtàadhɛ̏	CV̈CCCCVVChV
yʌ́ŋtīibhɛ̏n	CV̈CCCCVVCV
yʌ́ŋyʌ̏	CV̈CCCV̈
yédhábhɛ̏n	CVCVCV
yédhán	CVCV
yédhánzʌ̏	CVCVCV̈
yédhén	CVCV
yèê	CVV
yée	CVV
yéë	CVV
yèêdhȉ	CVVChV
yèêgā	CVVCV
yéegblɯ̄ŋ	CVVCCCV̈CC
yéi	CVV
yéizʌ̏	CVVCV̈
yɛ̏	CV
yɛ́	CV
yɛ̄an	CVVC
yɛ̀ɛ̂	CVV
yɛ̏ɛdhɤ̄	CVVChV̈
yɛ̄ɛn	CVVC
yɛ̄ɛntàabhȁ	CVVCCVVChV
yɛ́in	CVVC
yɛ̏iŋzʌ̏	CVVCCCV̈
yɛ́lɯ́	CVCV̈
yɛ́sɯ̏	CVCV̈
yɛ́tȁdhɛ	CVCVChV
yɛ̏tȁwɔ̀ɔ̏	CVCVwVV
yɛ̀ɯ	CVV̈
yī	CV
yī	CV
yī	CV
yī	CV
yī	CV
yí	CV
yí	CV
yí	CV
yï	CV
yî	CV
yìʌ̄	CVV̈
yìʌ̂	CVV̈
yīʌ	CVV̈
yīʌ	CVV̈
yīʌ̏	CVV̈
yīʌ̏	CVV̈
yīʌ̏	CVV̈
yíʌ	CVV̈
yíʌ̏	‘CVV̈
yíʌ̏	CVV̈
yíʌʌ	CVV̈V̈
yíʌ̏ʌn	CVV̈V̈C
yíʌ̈bīɤ	CVV̈CVV̈
yíʌ̈bhȁn	CVV̈CV
yíʌ̈bhɒ̀ɒ̄	CVV̈ChVV
yíʌ̈pȁ	CVV̈CV
yíblɯ̏bhɛ̏n	CVCCV̈CV
yíbhlétée	CVChCVCVV
yíbhɯ̄nkɔ̏ɔ	CVCV̈CVV
yíbhɯ̄nvɛ́dhɛ̏	CVCV̈vVChV
yídō	CVCV
yīdōʌ	CVCVV̈
yídhʌ́ngā	CVCV̈CV
yídhē	CVChV
yídhìān	CVCVV
yīɛn	CVVC
yīɛn	CVVC
yígā	CVCV
yíglōopíɤdhɛ̏	CVCCVVCVV̈ChV
yíglȕ	CVCCV
yígɔ̏	CVCV
yígɔ̏	CVCV
yígbā	CVCCV
yīgbȁnwȍ	CVCCVCwV
yȉisīʌ	CVVCVV̈
yīká	CVCV
yíkȁbhɛ̄dhʌ̏nwȕn	CVCVCCVChV̈wVC
yíkɔ̏dhʌ́n	CVCVCV̈
yíkpóŋ	CVCCVCC
yíkpóŋdhiɤ	CVCCVCCChVV̈
yíkpɤ̄	CVCCV̈
yīŋ̏	CVCC
yīŋ{yī}-dhȕn	CVCC {CV} CV
yīɤ	CVV̈
yīɤ	CVV̈
yīɤ	CVV̈
yípíɤ	CVCVV̈
yípíɤbhȁn	CVCVV̈CV
yípúʌ	CVCVV̈
yípúu	CVCVV
yísɛ́ɛ̈n	CVCVVC
yítȁ	CVCV
yítée	CVCVV
yítɔ́ɔ̈bhàadhɛ̏	CVCVVChVVChV
yítɔ́ɯ̈	CVCVV̈
yívà	CVvV
yízīʌnsɛ́gɔ̏	CVCVV̈CCVCV
yízȕɤdhɛ	CVCVV̈ChV
yȍŋ	CVCC
yóo	CVV
yóo	CVV
yóo	CVV
yɔ̏	CV
yɔ̄	CV
yɔ́	CV
yɔ̄âkʌ̏bhɛ̏n	CVVCV̈CV
yɔ́n	CVC
yɔ́n	CVC
yɔ́ngā	CVCCV
yɔ́ngɔ̏	CVCCV
yɔ́ŋ	CVCC
yɔ̀ɔ̄	CVV
yɔ̀ɔ̂	CVV
yɔ́ɔ	CVV
yɔ́ɔ	CVV
yɔ̏ɔbhɛ̄ân	CVVCCVV
yɔ̀ɔ̄dhɛ̏	CVVChV
yɔ̀ɔn	CVVC
yɔ̀ɔn	CVVC
yɔ́ɔ̈n	CVVC
yɔ́sɯ̏	CVCV̈
yɔ́sɯ̏zʌ̏	CVCV̈CV̈
yɔ̄zlȁ	CVCCV
yɤ̏	CV̈
yɤ̏	CV̈
yɤ̏	CV̈
yɤ̀	CV̈
yɤ̄	CV̈
yɤ̄	CV̈
yɤ̄	CV̈
yɤ́	CV̈
yɤ́	CV̈
yɤ̈	CV̈
yɤ̏ká	CV̈CV
yɤ̄ká	CV̈CV
yɤ̏kóʌdhɛ̏	CV̈CVV̈ChV
yɤ̏sōŋkʌ̄bhɛ̏n	CV̈CVCCCV̈CV
yɤ̏zlūdhʌdhíɤ	CV̈CCVChV̈ChVV̈
yúa	CVV
yúadhɛ	CVVChV
yúadhɛ̏n	CVVCChV
yūan	CVVC
yúazʌ̏	CVVCV̈
yuʌn	CVV̈C
yúʌnyȕʌn	CVV̈CCVV̈C
yūn	CVC
yūn	CVC
yūngɔ̄n	CVCCVC
yūngbɔ̄	CVCCCV
yúŋ̈	CVCC
yúŋ̈	CVCCC
yùɤ	CVV̈
yūɤ	CVV̈
yúɤ̈	CVV̈
yúɤ̈	CVV̈
yúɤgā	CVV̈CV
Yúu	YVV
yúü	CVV
yūun	CVVC
yúün	CVVC
yūungā	CVVCCV
zȁ	CV
zā	CV
zàā	CVV
zāâ	CVV
záa	CVV
zȁan	CVVC
zȁan	CVVC
zàanzán	CVVCCVC
zádhɤ̄	CVChV̈
zàgā	CVCV
zán	CVC
zàŋ	CVCC
záŋ	CVCC
zázádhɤ̄	CVCVChV̈
zɒ́ɒ	CVV
zɒ̄ɒdhe	CVVChV
zɒ̏ɒdhɤ̄n	CVVCChV̈
-zʌ̏	CV̈
-zʌ̏	CV̈
zʌ̄	CV̈
zʌ̄ʌ	CV̈V̈
zʌ́ʌdhē	CV̈V̈ChV
zʌ̄n	CV̈C
zʌ̄ngā	CV̈CCV
zʌ̄ngā	CV̈CCV
zʌ̄nzʌ̏	CV̈CCV̈
zʌ̄nzʌ̄nzʌ̏	CV̈CCV̈CCV̈
zʌ̄ŋgʌ̄	CV̈CCCV̈
zʌ̄ŋgbʌ̄	CV̈CCCCV̈
zʌ́ŋzʌ̏	CV̈CCCV̈
zʌ́ŋzʌ̏	CV̈CCCV̈
zʌ̄ɯ	CV̈V̈
zʌ̄ɯ	CV̈V̈
zē	CV
zéëwɔ́yɛ́gbàāngɯ́	CVVwVCVCCVVCCV̈
zēlɯ̏	CVCV̈
zȅŋgbȅkɔ̏dɔ̄dhagɔ̏	CVCCCCVCVCVChVCV
zètūbhādhen	CVCVCCVChV
zètūbhādhengā	CVCVCCVChVCV
zɛ̀	CV
zɛ́	CV
zɛ̄ɛ̂n	CVVC
zɛ̀gā	CVCV
zɛ̀ī	CVV
zɛ̄n	CVC
zɛ̄npʌ̄	CVCCV̈
zɛ́nzɛ̏n	CVCCVC
zíaa	CVVV
zīâdhɤn	CVVCChV̈
zȉan	CVVC
zìān	CVVC
zīan	CVVC
zīangā	CVVCCV
zīangblȍo	CVVCCCCVV
zīangblȍogā	CVVCCCCVVCV
zìʌ̄	CVV̈
zīʌ	CVV̈
zīʌ và	CVV̈ vV
zīʌn	CVV̈C
zīʌn	CVV̈C
zȉgā	CVCV
zȉi	CVV
zìi	CVV
zīi	CVV
zíi	CVV
zȉiŋ dhā	CVVCC ChV
zȉisɯ̏	CVVCV̈
zȉizʌ̏	CVVCV̈
zīizīi{dhȕ}n	CVVCVV {CV}
zīnpʌ̄	CVCCV̈
zȉoo	CVVV
zȉozʌ̄bhɛ̏n	CVVCV̈CV
zȉɔlógɔ̀ɔ̄	CVVCVCVV
zīɔn	CVVC
zīɤ	CVV̈
zíɤ̏	CVV̈
zíɤ̈ và	CVV̈ vV
zíɤ̏zʌ̏-dhȕn	CVV̈CV̈ CV
zȉɤzíɤ	CVV̈CVV̈
zīzī{dhȕ}n	CVCV {CV}
zláä	CCVV
zláädhʌ́dhēn	CCVVCV̈ChV
zláädhʌ́dhēnzʌ̏	CCVVCV̈ChVCV̈
zláädhēzʌ̏	CCVVChVCV̈
zláägɔ̄ɔ̂nzʌ̏	CCVVCVVCCV̈
zlȁbhɔnyāa	CCVCChVCVV
zlȁkpɔ̀ɔ	CCVCCVV
Zlȁn	ZCVC
zlȁnwȍpɤ̄bhɛ̏n	CCVCwVCV̈CV
zlɒ̀ɒ	CCVV
zlòa	CCVV
zlȍo	CCVV
zlòo	CCVV
zlòô	CCVV
zlɔ̀a	CCVV CV̈
zlɔ̄a	CCVV
zlɔ̀azʌ̏	CCVVCV̈
zlɔ̏ɔ	CCVV
zlɤ̀ɤ	CCV̈V̈
zlɤ̄ɤ	CCV̈V̈
zlɤ̀ɤdhɛ̏	CCV̈V̈ChV
zlɤ̀ɤdhɛ̏	CCV̈V̈ChV
zlū	CCV
zlú	CCV
zlùa	CCVV CV̈
zlūa	CCVV
zlūa	CCVV
zlūɛî	CCVVV
zlúsɔ̄	CCVCV
zlùu	CCVV
zȍ	CV
zō	CV
zō	CV
zòʌ̄kpʌ́ɯbȉzʌ̏	CVV̈CCV̈V̈CVCV̈
zȍdhɛ	CVChV
zódhɤ̄	CVChV̈
zȍgɔ́dhēn	CVCVCChV
zȍgbȁdhēn	CVCCVCChV
zȍgbéëdhɛ̏	CVCCVVChV
zòŋ̂	CVCC
zȍo	CVV
zòō	CVV
zóo	CVV
zóoyǣæn	CVVCVVC
zȍtádhē	CVCVChV
zózódhɤ̄	CVCVChV̈
zōzōzʌ̏	CVCVCV̈
zɔ̄	CV
zɔ́	CV
zɔ́	CV
zɔ̀ān	CVVC
zɔ̀ān	CVVC
zɔ́gā	CVCV
zɔ̏n	CVC
zɔ̏n	CVC
zɔ̄n	CVC
zɔ̀ŋgā	CVCCCCV
zɔ̏ɔ	CVV
zɔ̀ɔ	CVV
zɔ̄ɔ	CVV
zɔ́ɔ̈	CVV
zɔ̏ɔdhɤ̄n	CVVCChV̈
zɔ̀ɔn	CVVC
zɔ̀ɔngā	CVVCCV
zɔ́ü	CVV
zɤ̄	CV̈
zɤ̀ŋ̄	CV̈CC
zɤ̀ŋ̄ bɛ̏n	CV̈CC CVC
zɤ́ɯ	CV̈V̈
zūʌn	CVV̈C
zúɛdhɤ̄	CVVChV̈
zȕgā	CVCV
zūngblʌ̀ʌ̄	CVCCCCV̈V̈
zȕɤ	CVV̈
zȕɤ	CVV̈
zùɤ̄	CVV̈
zūɤ	CVV̈
zùɤ̄bȅ	CVV̈CV
zȕɤdɔ̄bhɛ̏n	CVV̈CVCV
zùɤ̄gā	CVV̈CV
zùɤ̄gʌ̄n	CVV̈CV̈C
zùɤ̄glúdhī	CVV̈CCVChV
zùɤ̄kȕnsīâdhe	CVV̈CVCCVVChV
zùɤ̄píɤyāabhɛ̏n	CVV̈CVV̈CVVCV
zùɤ̄púudhɛ̏	CVV̈CVVChV
zùɤ̄síɤ̈dhɛ̏	CVV̈CVV̈ChV
zùɤtȍzlɤ̀ɤdhē	CVV̈CVCCV̈V̈ChV
zùɤ̄vɔ̄ŋ	CVV̈vVCC
zùɤ̄wàādhūdhen	CVV̈wVVCCVChV
zùɤ̄yāabhɛ̏n	CVV̈CVVCV
zùɤ̄yȁglúu	CVV̈CVCCVV
zúsɯ̏	CVCV̈
zȕu	CVV
zȕugā	CVVCV
zúuzȕ	CVVCV
zúzáa	CVCVV
zɯ̏	CV̈
zɯ̄	CV̈
zɯ́	CV̈
zɯ̄dhí	CV̈ChV
zɯ̄gȍo	CV̈CVV
zɯ̄kpɤ̄	CV̈CCV̈
zɯ̏tódhɛ̏	CV̈CVChV
zɯ̄ɯ	CV̈V̈